"","fish_id","bin","LLLL","LLLR","LLRL","LLRR","LRLL","LRLR","LRRL","LRRR","RLLL","RLLR","RLRL","RLRR","RRLL","RRLR","RRRL","RRRR","L","R","total_turns","reps","alts","rel_reps","rel_alts","rel_R","rel_L"
"1","1","1",41,9,7,5,6,3,5,5,10,3,2,4,7,3,5,0,84,34,118,41,5,34.7457627118644,4.23728813559322,28.8135593220339,71.1864406779661
"2","1","2",54,5,1,4,1,0,4,0,4,1,0,0,4,0,0,0,71,10,81,54,0,66.6666666666667,0,12.3456790123457,87.6543209876543
"3","1","3",58,2,1,1,1,0,1,0,2,0,0,0,1,0,0,0,67,3,70,58,0,82.8571428571429,0,4.28571428571429,95.7142857142857
"4","1","4",54,4,2,2,2,0,2,0,3,0,0,0,2,0,0,0,68,6,74,54,0,72.972972972973,0,8.10810810810811,91.8918918918919
"5","1","5",49,1,1,0,1,0,0,0,1,0,0,0,0,0,0,0,55,1,56,49,0,87.5,0,1.78571428571429,98.2142857142857
"6","1","6",59,3,3,0,3,1,0,0,3,0,1,0,0,0,0,0,72,4,76,59,2,77.6315789473684,2.63157894736842,5.26315789473684,94.7368421052632
"7","10","1",0,0,2,2,3,4,1,5,0,4,5,3,1,4,4,8,17,32,49,8,9,16.3265306122449,18.3673469387755,65.3061224489796,34.6938775510204
"8","10","2",0,0,0,0,0,1,0,2,0,0,1,2,0,2,2,38,3,48,51,38,2,74.5098039215686,3.92156862745098,94.1176470588235,5.88235294117647
"9","10","3",0,0,0,0,0,1,0,4,0,0,1,4,0,4,4,12,5,28,33,12,2,36.3636363636364,6.06060606060606,84.8484848484848,15.1515151515152
"10","10","4",0,0,0,0,0,0,0,0,0,0,0,0,0,0,0,36,0,39,39,36,0,92.3076923076923,0,100,0
"11","10","5",0,0,0,2,0,1,1,6,0,2,1,4,2,4,6,21,11,42,53,21,2,39.622641509434,3.77358490566038,79.2452830188679,20.7547169811321
"12","10","6",0,0,0,0,0,1,0,3,0,0,1,2,0,3,3,27,5,38,43,27,2,62.7906976744186,4.65116279069767,88.3720930232558,11.6279069767442
"13","100","1",1,3,4,0,2,6,1,2,3,1,5,3,2,1,2,0,21,18,39,1,11,2.56410256410256,28.2051282051282,46.1538461538462,53.8461538461538
"14","100","2",0,1,1,1,0,1,0,2,1,1,0,1,1,0,1,1,6,9,15,1,1,6.66666666666667,6.66666666666667,60,40
"15","100","3",0,0,0,3,0,0,0,8,0,3,0,4,3,4,7,66,11,90,101,66,0,65.3465346534653,0,89.1089108910891,10.8910891089109
"16","100","4",0,0,0,2,1,0,2,5,0,2,1,5,1,6,6,67,11,90,101,67,1,66.3366336633663,0.99009900990099,89.1089108910891,10.8910891089109
"17","100","5",0,0,0,0,0,2,0,4,0,0,1,5,0,4,4,65,7,81,88,65,3,73.8636363636364,3.40909090909091,92.0454545454545,7.95454545454545
"18","100","6",0,2,1,2,0,2,2,12,2,1,1,12,3,11,12,47,21,92,113,47,3,41.5929203539823,2.65486725663717,81.4159292035398,18.5840707964602
"19","101","1",8,7,11,4,13,13,5,5,7,9,15,5,3,7,5,3,68,55,123,11,28,8.94308943089431,22.7642276422764,44.7154471544715,55.2845528455285
"20","101","2",12,4,6,2,5,13,1,4,4,5,12,3,4,1,4,2,49,36,85,14,25,16.4705882352941,29.4117647058824,42.3529411764706,57.6470588235294
"21","101","3",19,11,16,4,16,3,2,3,10,9,3,1,3,1,3,3,75,35,110,22,6,20,5.45454545454545,31.8181818181818,68.1818181818182
"22","101","4",25,5,7,0,7,2,0,0,5,2,2,0,0,0,0,0,49,9,58,25,4,43.1034482758621,6.89655172413793,15.5172413793103,84.4827586206897
"23","101","5",36,5,5,3,5,3,2,1,4,3,4,0,2,1,1,3,62,19,81,39,7,48.1481481481481,8.64197530864197,23.4567901234568,76.5432098765432
"24","101","6",10,4,7,2,8,16,2,1,4,4,17,2,0,3,1,1,51,34,85,11,33,12.9411764705882,38.8235294117647,40,60
"25","102","1",4,5,2,5,5,7,7,4,5,2,10,6,2,9,4,1,40,41,81,5,17,6.17283950617284,20.9876543209877,50.6172839506173,49.3827160493827
"26","102","2",1,0,2,3,3,8,5,5,1,5,8,7,3,7,5,5,30,41,71,6,16,8.45070422535211,22.5352112676056,57.7464788732394,42.2535211267606
"27","102","3",13,6,10,1,9,19,2,0,6,5,18,1,3,0,0,0,62,34,96,13,37,13.5416666666667,38.5416666666667,35.4166666666667,64.5833333333333
"28","102","4",50,6,6,0,7,1,0,0,7,0,1,0,0,0,0,0,73,8,81,50,2,61.7283950617284,2.46913580246914,9.87654320987654,90.1234567901235
"29","102","5",38,8,8,1,9,3,1,0,8,2,3,0,1,0,0,0,70,15,85,38,6,44.7058823529412,7.05882352941176,17.6470588235294,82.3529411764706
"30","102","6",18,5,12,0,10,7,3,0,6,7,5,3,3,0,0,0,58,24,82,18,12,21.9512195121951,14.6341463414634,29.2682926829268,70.7317073170732
"31","103","1",2,3,4,4,6,10,5,11,3,6,12,11,3,13,11,22,47,82,129,24,22,18.6046511627907,17.0542635658915,63.5658914728682,36.4341085271318
"32","103","2",0,3,1,5,4,11,5,8,3,3,14,8,2,11,8,14,39,64,103,14,25,13.5922330097087,24.2718446601942,62.1359223300971,37.8640776699029
"33","103","3",1,1,2,0,1,5,1,3,1,1,4,4,1,4,4,5,15,26,41,6,9,14.6341463414634,21.9512195121951,63.4146341463415,36.5853658536585
"34","103","4",0,0,0,0,0,2,0,2,0,0,2,1,0,2,2,8,5,17,22,8,4,36.3636363636364,18.1818181818182,77.2727272727273,22.7272727272727
"35","103","5",0,0,0,1,0,1,1,1,0,1,0,1,1,0,0,1,4,7,11,1,1,9.09090909090909,9.09090909090909,63.6363636363636,36.3636363636364
"36","103","6",0,0,0,0,0,1,1,1,0,0,1,1,0,1,1,2,4,8,12,2,2,16.6666666666667,16.6666666666667,66.6666666666667,33.3333333333333
"37","104","1",4,8,11,8,14,13,6,7,8,10,16,5,4,9,7,6,72,67,139,10,29,7.19424460431655,20.863309352518,48.2014388489209,51.7985611510791
"38","104","2",6,6,7,7,9,13,5,10,6,7,15,8,4,11,10,20,64,83,147,26,28,17.687074829932,19.047619047619,56.4625850340136,43.5374149659864
"39","104","3",1,1,1,2,1,8,2,14,1,2,8,14,2,14,13,65,30,122,152,66,16,43.4210526315789,10.5263157894737,80.2631578947368,19.7368421052632
"40","104","4",0,0,1,4,2,4,5,9,0,5,5,10,3,11,8,16,25,61,86,16,9,18.6046511627907,10.4651162790698,70.9302325581395,29.0697674418605
"41","104","5",0,1,5,3,2,13,5,7,1,7,10,8,6,5,7,10,37,56,93,10,23,10.752688172043,24.7311827956989,60.2150537634409,39.7849462365591
"42","104","6",0,0,4,3,4,27,6,3,0,7,27,6,3,7,4,5,48,61,109,5,54,4.58715596330275,49.5412844036697,55.9633027522936,44.0366972477064
"43","105","1",10,9,7,8,7,2,6,5,9,7,2,3,9,3,5,0,56,39,95,10,4,10.5263157894737,4.21052631578947,41.0526315789474,58.9473684210526
"44","105","2",1,2,4,4,5,8,2,8,2,6,9,6,3,7,9,14,35,58,93,15,17,16.1290322580645,18.2795698924731,62.3655913978495,37.6344086021505
"45","105","3",0,0,0,1,0,0,0,2,0,1,0,1,1,1,2,80,3,89,92,80,0,86.9565217391304,0,96.7391304347826,3.26086956521739
"46","105","4",0,0,0,2,1,2,2,3,0,2,3,3,1,4,3,25,10,44,54,25,5,46.2962962962963,9.25925925925926,81.4814814814815,18.5185185185185
"47","105","5",0,0,0,0,0,0,1,0,0,1,0,1,1,1,1,70,3,76,79,70,0,88.6075949367089,0,96.2025316455696,3.79746835443038
"48","105","6",0,0,0,2,1,0,0,3,0,2,1,1,1,2,2,83,6,95,101,83,1,82.1782178217822,0.99009900990099,94.0594059405941,5.94059405940594
"49","106","1",25,4,4,1,4,6,2,3,3,2,6,4,1,4,3,3,51,27,78,28,12,35.8974358974359,15.3846153846154,34.6153846153846,65.3846153846154
"50","106","2",4,2,7,4,6,7,3,6,2,9,6,5,5,3,6,5,40,43,83,9,13,10.8433734939759,15.6626506024096,51.8072289156626,48.1927710843374
"51","106","3",2,3,5,1,5,13,4,3,3,3,12,6,1,6,3,4,37,40,77,6,25,7.79220779220779,32.4675324675325,51.9480519480519,48.0519480519481
"52","106","4",7,3,3,5,4,15,6,2,3,5,15,3,4,4,2,2,46,40,86,9,30,10.4651162790698,34.8837209302326,46.5116279069767,53.4883720930233
"53","106","5",2,2,6,5,5,11,10,4,2,9,11,9,6,8,4,3,47,53,100,5,22,5,22,53,47
"54","106","6",2,1,4,6,3,11,11,1,1,9,10,7,7,6,2,6,40,50,90,8,21,8.88888888888889,23.3333333333333,55.5555555555556,44.4444444444444
"55","107","1",6,4,3,7,6,2,5,3,4,6,5,1,4,4,3,5,37,34,71,11,7,15.4929577464789,9.85915492957746,47.887323943662,52.112676056338
"56","107","2",3,4,4,4,5,3,3,2,4,4,5,1,3,3,2,2,30,25,55,5,8,9.09090909090909,14.5454545454545,45.4545454545455,54.5454545454545
"57","107","3",0,2,1,3,3,13,5,3,2,2,15,5,1,8,3,2,31,40,71,2,28,2.8169014084507,39.4366197183099,56.3380281690141,43.6619718309859
"58","107","4",0,0,0,0,0,1,0,3,0,1,1,3,1,3,3,21,6,34,40,21,2,52.5,5,85,15
"59","107","5",0,0,0,1,0,0,3,2,0,1,0,4,2,4,3,9,8,24,32,9,0,28.125,0,75,25
"60","107","6",0,0,0,2,0,0,0,3,0,2,0,1,2,2,4,11,6,24,30,11,0,36.6666666666667,0,80,20
"61","108","1",4,6,6,7,5,18,5,8,6,7,17,6,8,4,7,6,59,64,123,10,35,8.13008130081301,28.4552845528455,52.0325203252033,47.9674796747967
"62","108","2",11,8,11,6,9,17,10,5,8,9,15,9,8,7,5,3,79,65,144,14,32,9.72222222222222,22.2222222222222,45.1388888888889,54.8611111111111
"63","108","3",49,14,10,5,9,2,5,0,14,1,2,0,5,0,0,0,96,23,119,49,4,41.1764705882353,3.36134453781513,19.327731092437,80.672268907563
"64","108","4",30,11,8,4,10,2,4,1,12,1,4,1,3,2,1,0,73,24,97,30,6,30.9278350515464,6.18556701030928,24.7422680412371,75.2577319587629
"65","108","5",1,3,3,0,1,5,1,0,2,0,4,1,1,0,0,0,16,9,25,1,9,4,36,36,64
"66","108","6",22,5,7,1,7,5,1,0,6,3,5,0,1,0,0,0,51,15,66,22,10,33.3333333333333,15.1515151515152,22.7272727272727,77.2727272727273
"67","109","1",0,3,1,2,0,4,3,7,3,0,3,8,3,8,8,9,21,44,65,9,7,13.8461538461538,10.7692307692308,67.6923076923077,32.3076923076923
"68","109","2",1,2,4,1,3,17,2,7,3,3,16,8,3,7,8,17,40,65,105,18,33,17.1428571428571,31.4285714285714,61.9047619047619,38.0952380952381
"69","109","3",2,3,5,3,5,13,4,4,2,5,13,5,2,6,4,4,40,43,83,6,26,7.2289156626506,31.3253012048193,51.8072289156626,48.1927710843374
"70","109","4",0,1,0,2,1,1,1,5,1,1,1,5,1,5,5,49,12,70,82,49,2,59.7560975609756,2.4390243902439,85.3658536585366,14.6341463414634
"71","109","5",0,0,0,1,0,0,0,1,0,1,0,0,1,0,1,41,2,47,49,41,0,83.6734693877551,0,95.9183673469388,4.08163265306122
"72","109","6",0,0,0,0,0,2,1,2,0,0,2,3,0,2,1,39,5,50,55,39,4,70.9090909090909,7.27272727272727,90.9090909090909,9.09090909090909
"73","11","1",0,0,1,2,1,6,3,5,0,3,6,6,2,7,6,13,19,45,64,13,12,20.3125,18.75,70.3125,29.6875
"74","11","2",0,1,1,1,0,4,2,6,1,1,3,7,2,6,6,19,15,48,63,19,7,30.1587301587302,11.1111111111111,76.1904761904762,23.8095238095238
"75","11","3",0,0,1,2,1,0,0,5,0,3,0,4,2,4,5,42,10,62,72,42,0,58.3333333333333,0,86.1111111111111,13.8888888888889
"76","11","4",0,0,0,0,0,0,0,1,0,0,0,1,0,1,1,62,1,68,69,62,0,89.8550724637681,0,98.5507246376812,1.44927536231884
"77","11","5",0,0,0,0,0,0,1,2,0,0,0,3,0,3,2,30,3,41,44,30,0,68.1818181818182,0,93.1818181818182,6.81818181818182
"78","11","6",0,0,0,0,0,0,1,4,0,0,0,5,0,5,4,39,5,56,61,39,0,63.9344262295082,0,91.8032786885246,8.19672131147541
"79","110","1",0,1,1,0,1,3,1,1,0,0,3,2,0,2,1,3,10,12,22,3,6,13.6363636363636,27.2727272727273,54.5454545454545,45.4545454545455
"80","110","2",5,2,3,3,5,10,5,0,2,4,11,2,1,3,0,0,34,25,59,5,21,8.47457627118644,35.5932203389831,42.3728813559322,57.6271186440678
"81","110","3",1,2,1,5,3,7,6,8,2,4,9,8,3,10,7,19,33,65,98,20,16,20.4081632653061,16.3265306122449,66.3265306122449,33.6734693877551
"82","110","4",0,0,0,0,0,1,0,6,0,0,1,6,0,6,6,77,7,99,106,77,2,72.6415094339623,1.88679245283019,93.3962264150943,6.60377358490566
"83","110","5",0,0,2,0,2,4,0,2,0,2,4,2,0,1,1,54,10,67,77,54,8,70.1298701298701,10.3896103896104,87.012987012987,12.987012987013
"84","110","6",0,0,0,0,0,1,0,4,0,0,1,4,0,4,4,51,5,67,72,51,2,70.8333333333333,2.77777777777778,93.0555555555556,6.94444444444444
"85","111","1",8,5,7,5,3,9,10,5,6,6,5,10,9,6,5,8,55,55,110,16,14,14.5454545454545,12.7272727272727,50,50
"86","111","2",1,2,4,0,1,10,3,6,2,2,7,9,3,6,6,7,28,44,72,8,17,11.1111111111111,23.6111111111111,61.1111111111111,38.8888888888889
"87","111","3",0,0,2,0,1,11,3,8,0,2,9,11,1,10,8,8,26,51,77,8,20,10.3896103896104,25.974025974026,66.2337662337662,33.7662337662338
"88","111","4",0,1,0,3,0,6,6,8,1,1,6,12,2,12,8,20,25,64,89,20,12,22.4719101123596,13.4831460674157,71.9101123595506,28.0898876404494
"89","111","5",0,1,0,1,0,4,1,6,1,0,4,6,1,6,6,22,14,48,62,22,8,35.4838709677419,12.9032258064516,77.4193548387097,22.5806451612903
"90","111","6",1,4,1,5,1,0,3,5,4,2,0,3,5,2,4,8,20,31,51,9,0,17.6470588235294,0,60.7843137254902,39.2156862745098
"91","112","1",2,1,0,2,2,4,0,4,1,1,6,2,0,3,3,27,15,46,61,29,10,47.5409836065574,16.3934426229508,75.4098360655738,24.5901639344262
"92","112","2",0,1,0,3,0,1,1,10,1,2,1,8,3,7,9,30,16,64,80,30,2,37.5,2.5,80,20
"93","112","3",0,0,1,0,0,2,0,4,0,1,1,4,1,3,4,24,7,41,48,24,3,50,6.25,85.4166666666667,14.5833333333333
"94","112","4",0,0,0,0,0,0,2,1,0,0,0,4,0,4,2,15,4,27,31,15,0,48.3870967741936,0,87.0967741935484,12.9032258064516
"95","112","5",0,0,0,2,1,0,1,1,0,2,1,0,2,1,2,3,7,12,19,3,1,15.7894736842105,5.26315789473684,63.1578947368421,36.8421052631579
"96","112","6",0,0,0,1,0,0,0,1,0,1,0,0,1,0,1,3,2,9,11,3,0,27.2727272727273,0,81.8181818181818,18.1818181818182
"97","12","1",0,1,3,3,3,3,1,7,0,6,3,5,3,5,7,10,23,40,63,10,6,15.8730158730159,9.52380952380952,63.4920634920635,36.5079365079365
"98","12","2",7,3,3,1,4,4,2,2,3,1,6,2,0,4,2,3,28,22,50,10,10,20,20,44,56
"99","12","3",13,3,2,1,2,0,1,0,2,0,1,0,0,1,0,0,24,5,29,13,1,44.8275862068966,3.44827586206897,17.2413793103448,82.7586206896552
"100","12","4",9,5,4,4,3,1,5,0,4,3,1,1,4,1,0,0,33,15,48,9,2,18.75,4.16666666666667,31.25,68.75
"101","12","5",11,5,2,5,3,0,3,2,4,2,1,0,3,1,2,0,32,15,47,11,1,23.4042553191489,2.12765957446809,31.9148936170213,68.0851063829787
"102","12","6",19,2,1,0,1,0,0,0,1,0,0,0,0,0,0,0,25,2,27,19,0,70.3703703703704,0,7.40740740740741,92.5925925925926
"103","13","1",28,10,10,2,9,7,2,3,11,2,6,3,4,1,3,8,74,38,112,36,13,32.1428571428571,11.6071428571429,33.9285714285714,66.0714285714286
"104","13","2",41,9,10,4,10,6,6,0,8,5,6,2,4,2,0,0,88,28,116,41,12,35.3448275862069,10.3448275862069,24.1379310344828,75.8620689655172
"105","13","3",22,6,7,2,5,9,1,5,6,3,7,4,4,2,5,1,60,32,92,23,16,25,17.3913043478261,34.7826086956522,65.2173913043478
"106","13","4",5,6,9,6,9,10,6,4,6,9,10,4,6,4,4,1,56,46,102,6,20,5.88235294117647,19.6078431372549,45.0980392156863,54.9019607843137
"107","13","5",12,4,6,4,6,13,5,1,4,5,13,3,3,3,1,1,52,35,87,13,26,14.9425287356322,29.8850574712644,40.2298850574713,59.7701149425287
"108","13","6",2,3,2,2,2,7,2,8,3,2,6,8,3,7,8,31,30,69,99,33,13,33.3333333333333,13.1313131313131,69.6969696969697,30.3030303030303
"109","14","1",0,1,2,2,2,6,3,3,1,4,6,4,3,4,3,4,21,30,51,4,12,7.84313725490196,23.5294117647059,58.8235294117647,41.1764705882353
"110","14","2",0,0,1,1,1,4,1,0,0,2,5,0,1,1,0,0,10,10,20,0,9,0,45,50,50
"111","14","3",0,1,1,0,1,2,0,0,1,0,2,0,0,0,0,0,8,3,11,0,4,0,36.3636363636364,27.2727272727273,72.7272727272727
"112","14","4",0,0,0,1,0,0,1,0,0,0,0,0,0,1,0,0,3,3,6,0,0,0,0,50,50
"113","14","5",0,0,1,0,0,1,0,1,0,0,0,1,0,0,0,1,3,5,8,1,1,12.5,12.5,62.5,37.5
"114","14","6",0,0,0,0,0,2,1,1,0,0,1,2,0,1,0,5,4,12,16,5,3,31.25,18.75,75,25
"115","15","1",8,11,13,6,12,5,6,3,11,8,4,4,7,3,4,6,65,49,114,14,9,12.280701754386,7.89473684210526,42.9824561403509,57.0175438596491
"116","15","2",17,7,7,3,5,5,5,1,7,3,3,3,5,1,1,0,53,23,76,17,8,22.3684210526316,10.5263157894737,30.2631578947368,69.7368421052632
"117","15","3",16,7,6,3,5,13,8,1,6,2,12,6,3,6,1,0,60,38,98,16,25,16.3265306122449,25.5102040816327,38.7755102040816,61.2244897959184
"118","15","4",38,8,6,4,4,4,5,1,8,2,3,2,6,1,1,0,72,24,96,38,7,39.5833333333333,7.29166666666667,25,75
"119","15","5",2,4,2,3,1,8,4,7,3,1,7,8,3,7,6,7,31,45,76,9,15,11.8421052631579,19.7368421052632,59.2105263157895,40.7894736842105
"120","15","6",2,2,2,2,1,2,2,8,2,2,2,8,3,8,9,22,23,57,80,24,4,30,5,71.25,28.75
"121","16","1",10,9,14,3,12,7,2,4,9,8,4,4,5,1,4,2,62,39,101,12,11,11.8811881188119,10.8910891089109,38.6138613861386,61.3861386138614
"122","16","2",0,1,2,3,1,7,7,2,1,4,5,6,4,5,2,0,24,29,53,0,12,0,22.6415094339623,54.7169811320755,45.2830188679245
"123","16","3",1,2,2,3,0,3,4,5,1,3,1,6,4,4,4,8,20,34,54,9,4,16.6666666666667,7.40740740740741,62.962962962963,37.037037037037
"124","16","4",0,0,2,0,2,13,1,0,0,2,14,1,0,2,0,0,20,20,40,0,27,0,67.5,50,50
"125","16","5",0,0,3,0,2,7,3,0,0,3,7,3,1,3,0,0,17,18,35,0,14,0,40,51.4285714285714,48.5714285714286
"126","16","6",0,1,4,2,5,8,5,1,1,6,9,4,2,4,1,1,28,29,57,1,17,1.75438596491228,29.8245614035088,50.8771929824561,49.1228070175439
"127","17","1",0,1,6,4,7,5,4,3,1,9,7,3,3,4,3,14,32,45,77,14,12,18.1818181818182,15.5844155844156,58.4415584415584,41.5584415584416
"128","17","2",0,0,0,1,0,0,1,0,0,1,0,0,0,0,0,0,3,3,6,0,0,0,0,50,50
"129","17","3",0,0,0,0,0,0,0,0,0,0,0,0,0,0,0,0,0,0,0,0,0,NA,NA,NA,NA
"130","17","4",0,0,0,0,0,0,0,0,0,0,0,0,0,0,0,0,0,0,0,0,0,NA,NA,NA,NA
"131","17","5",0,0,0,0,0,0,0,0,0,0,0,0,0,0,0,0,0,2,2,0,0,0,0,100,0
"132","17","6",0,0,0,0,0,0,0,0,0,0,0,0,0,0,0,0,1,2,3,0,0,0,0,66.6666666666667,33.3333333333333
"133","18","1",8,6,4,7,3,2,5,6,6,4,1,4,7,3,5,2,41,35,76,10,3,13.1578947368421,3.94736842105263,46.0526315789474,53.9473684210526
"134","18","2",8,6,3,3,4,0,1,2,6,1,0,0,3,0,2,0,29,13,42,8,0,19.047619047619,0,30.952380952381,69.0476190476191
"135","18","3",0,0,0,1,1,2,1,0,0,1,3,0,0,1,0,0,7,6,13,0,5,0,38.4615384615385,46.1538461538462,53.8461538461538
"136","18","4",3,2,1,2,1,0,2,0,2,1,0,0,2,0,0,0,13,6,19,3,0,15.7894736842105,0,31.5789473684211,68.4210526315789
"137","18","5",2,2,3,1,2,2,1,1,2,1,1,1,1,1,1,1,15,11,26,3,3,11.5384615384615,11.5384615384615,42.3076923076923,57.6923076923077
"138","18","6",2,2,4,0,2,13,1,1,2,2,12,2,1,1,1,1,27,23,50,3,25,6,50,46,54
"139","19","1",22,8,10,6,9,14,4,5,8,7,13,3,6,2,4,5,78,51,129,27,27,20.9302325581395,20.9302325581395,39.5348837209302,60.4651162790698
"140","19","2",46,13,11,2,12,3,3,1,14,0,4,2,2,2,1,0,94,25,119,46,7,38.6554621848739,5.88235294117647,21.0084033613445,78.9915966386555
"141","19","3",33,9,6,4,6,8,2,4,9,1,8,2,4,2,4,1,75,31,106,34,16,32.0754716981132,15.0943396226415,29.2452830188679,70.7547169811321
"142","19","4",8,6,6,3,6,12,6,2,7,3,12,5,4,5,2,1,52,39,91,9,24,9.89010989010989,26.3736263736264,42.8571428571429,57.1428571428571
"143","19","5",24,6,8,1,7,7,2,0,5,3,7,1,1,1,0,0,57,19,76,24,14,31.5789473684211,18.4210526315789,25,75
"144","19","6",19,7,6,2,7,7,2,1,8,1,8,1,2,1,1,0,54,22,76,19,15,25,19.7368421052632,28.9473684210526,71.0526315789474
"145","2","1",20,13,12,7,11,5,8,5,13,6,5,6,8,5,5,1,83,50,133,21,10,15.7894736842105,7.5187969924812,37.593984962406,62.406015037594
"146","2","2",11,6,5,6,2,7,5,7,6,5,4,6,10,3,8,14,51,57,108,25,11,23.1481481481481,10.1851851851852,52.7777777777778,47.2222222222222
"147","2","3",9,5,4,4,4,4,5,1,4,4,4,2,4,2,1,1,38,23,61,10,8,16.3934426229508,13.1147540983607,37.7049180327869,62.2950819672131
"148","2","4",1,3,2,3,2,6,3,5,3,2,6,5,4,5,6,6,27,38,65,7,12,10.7692307692308,18.4615384615385,58.4615384615385,41.5384615384615
"149","2","5",0,2,3,1,3,4,2,3,2,2,4,3,1,3,2,1,18,21,39,1,8,2.56410256410256,20.5128205128205,53.8461538461538,46.1538461538462
"150","2","6",2,2,3,5,5,5,2,3,2,6,6,1,3,2,3,2,28,27,55,4,11,7.27272727272727,20,49.0909090909091,50.9090909090909
"151","20","1",0,1,1,3,2,0,1,5,1,3,1,3,2,4,5,7,13,29,42,7,1,16.6666666666667,2.38095238095238,69.0476190476191,30.952380952381
"152","20","2",0,0,0,1,0,0,1,0,0,1,0,0,1,0,0,0,4,3,7,0,0,0,0,42.8571428571429,57.1428571428571
"153","20","3",0,0,0,0,0,0,0,0,0,0,0,0,0,0,0,0,0,1,1,0,0,0,0,100,0
"154","20","4",0,0,0,0,0,0,0,0,0,0,0,0,0,0,0,0,0,0,0,0,0,NA,NA,NA,NA
"155","20","5",0,0,0,0,0,0,0,0,0,0,0,0,0,0,0,0,0,0,0,0,0,NA,NA,NA,NA
"156","20","6",0,0,0,0,0,0,0,0,0,0,0,0,0,0,0,0,0,0,0,0,0,NA,NA,NA,NA
"157","21","1",0,0,0,3,1,0,2,1,0,3,1,1,2,2,1,1,8,13,21,1,1,4.76190476190476,4.76190476190476,61.9047619047619,38.0952380952381
"158","21","2",0,0,0,0,0,0,0,0,0,0,0,0,0,1,0,0,1,3,4,0,0,0,0,75,25
"159","21","3",0,0,0,0,0,0,0,0,0,0,0,0,0,0,0,0,0,1,1,0,0,0,0,100,0
"160","21","4",0,0,0,0,0,0,0,0,0,0,0,0,0,0,0,0,0,0,0,0,0,NA,NA,NA,NA
"161","21","5",0,0,0,0,0,0,0,0,0,0,0,0,0,0,0,0,0,0,0,0,0,NA,NA,NA,NA
"162","21","6",0,0,0,0,0,0,0,0,0,0,0,0,0,0,0,0,0,1,1,0,0,0,0,100,0
"163","22","1",0,0,1,2,0,3,3,5,0,3,2,6,2,5,5,7,15,32,47,7,5,14.8936170212766,10.6382978723404,68.0851063829787,31.9148936170213
"164","22","2",0,0,1,1,1,2,3,0,0,2,1,2,1,1,0,0,9,9,18,0,3,0,16.6666666666667,50,50
"165","22","3",0,0,1,0,1,2,1,0,0,1,2,1,0,1,0,0,6,7,13,0,4,0,30.7692307692308,53.8461538461538,46.1538461538462
"166","22","4",0,0,1,0,1,2,0,0,0,1,1,0,0,0,0,0,5,4,9,0,3,0,33.3333333333333,44.4444444444444,55.5555555555556
"167","22","5",0,0,0,0,0,0,1,2,0,0,0,2,0,2,2,1,4,9,13,1,0,7.69230769230769,0,69.2307692307692,30.7692307692308
"168","22","6",0,0,0,0,0,1,0,0,0,0,2,0,0,0,0,0,3,3,6,0,3,0,50,50,50
"169","23","1",14,5,4,5,6,6,3,6,5,4,7,4,4,5,6,3,51,39,90,17,13,18.8888888888889,14.4444444444444,43.3333333333333,56.6666666666667
"170","23","2",1,5,7,4,7,12,7,2,5,7,12,5,5,5,2,4,47,46,93,5,24,5.37634408602151,25.8064516129032,49.4623655913978,50.5376344086022
"171","23","3",3,4,7,3,6,18,5,1,4,6,18,2,4,2,1,1,49,39,88,4,36,4.54545454545455,40.9090909090909,44.3181818181818,55.6818181818182
"172","23","4",1,2,3,3,2,12,5,4,1,4,11,6,3,5,4,3,33,39,72,4,23,5.55555555555556,31.9444444444444,54.1666666666667,45.8333333333333
"173","23","5",0,0,2,2,3,18,5,1,0,4,19,4,1,4,1,1,32,36,68,1,37,1.47058823529412,54.4117647058824,52.9411764705882,47.0588235294118
"174","23","6",0,0,5,0,5,14,5,0,0,5,14,5,0,4,0,0,30,30,60,0,28,0,46.6666666666667,50,50
"175","24","1",0,0,0,0,0,2,1,0,0,0,2,2,0,2,1,3,4,12,16,3,4,18.75,25,75,25
"176","24","2",0,0,0,0,0,0,1,3,0,0,0,4,0,4,2,5,4,18,22,5,0,22.7272727272727,0,81.8181818181818,18.1818181818182
"177","24","3",0,0,0,0,0,2,0,1,0,0,2,1,0,0,0,2,3,8,11,2,4,18.1818181818182,36.3636363636364,72.7272727272727,27.2727272727273
"178","24","4",0,0,0,0,0,1,0,0,0,0,1,0,0,0,0,0,2,3,5,0,2,0,40,60,40
"179","24","5",0,1,0,1,0,0,0,0,1,0,0,0,0,0,0,0,3,3,6,0,0,0,0,50,50
"180","24","6",0,0,0,0,0,0,0,1,0,0,0,1,0,1,0,0,1,5,6,0,0,0,0,83.3333333333333,16.6666666666667
"181","25","1",0,0,0,2,2,14,0,4,0,2,15,2,0,3,3,8,22,36,58,8,29,13.7931034482759,50,62.0689655172414,37.9310344827586
"182","25","2",0,0,0,0,0,5,0,5,0,0,5,5,0,5,5,33,10,56,66,33,10,50,15.1515151515152,84.8484848484848,15.1515151515152
"183","25","3",0,0,0,0,0,0,0,5,0,0,0,5,0,5,5,54,5,72,77,54,0,70.1298701298701,0,93.5064935064935,6.49350649350649
"184","25","4",0,0,0,0,0,0,0,1,0,0,0,1,0,1,1,54,1,60,61,54,0,88.5245901639344,0,98.3606557377049,1.63934426229508
"185","25","5",0,0,0,0,0,0,1,4,0,0,0,4,0,4,3,40,5,54,59,40,0,67.7966101694915,0,91.5254237288136,8.47457627118644
"186","25","6",0,0,0,0,0,2,0,4,0,0,2,4,0,4,4,35,7,51,58,35,4,60.3448275862069,6.89655172413793,87.9310344827586,12.0689655172414
"187","26","1",31,9,9,2,9,4,2,1,10,2,4,1,2,1,1,2,70,23,93,33,8,35.4838709677419,8.60215053763441,24.7311827956989,75.2688172043011
"188","26","2",23,7,7,3,7,3,0,4,6,3,3,1,2,1,3,3,54,25,79,26,6,32.9113924050633,7.59493670886076,31.6455696202532,68.3544303797468
"189","26","3",3,3,5,3,8,6,1,3,3,5,9,2,0,4,3,6,33,34,67,9,15,13.4328358208955,22.3880597014925,50.7462686567164,49.2537313432836
"190","26","4",0,0,1,1,1,2,1,4,0,2,2,4,1,4,4,33,10,53,63,33,4,52.3809523809524,6.34920634920635,84.1269841269841,15.8730158730159
"191","26","5",0,0,1,2,1,4,2,6,0,3,4,6,2,6,6,12,18,40,58,12,8,20.6896551724138,13.7931034482759,68.9655172413793,31.0344827586207
"192","26","6",1,1,0,1,0,6,0,4,1,0,6,3,1,2,3,11,13,30,43,12,12,27.906976744186,27.906976744186,69.7674418604651,30.2325581395349
"193","27","1",0,2,1,4,0,1,2,4,2,3,0,2,4,2,4,8,15,27,42,8,1,19.047619047619,2.38095238095238,64.2857142857143,35.7142857142857
"194","27","2",0,0,0,1,0,0,1,2,0,1,0,2,1,2,2,22,4,33,37,22,0,59.4594594594595,0,89.1891891891892,10.8108108108108
"195","27","3",0,1,1,2,0,0,0,3,1,2,0,1,3,1,4,33,9,46,55,33,0,60,0,83.6363636363636,16.3636363636364
"196","27","4",3,0,0,1,1,1,0,4,1,1,2,3,1,3,4,5,13,20,33,8,3,24.2424242424242,9.09090909090909,60.6060606060606,39.3939393939394
"197","27","5",6,3,3,1,3,1,1,1,2,1,2,1,0,2,1,1,21,11,32,7,3,21.875,9.375,34.375,65.625
"198","27","6",5,4,5,1,6,3,1,0,3,2,4,0,0,1,0,0,27,11,38,5,7,13.1578947368421,18.4210526315789,28.9473684210526,71.0526315789474
"199","28","1",4,4,3,3,3,7,3,9,4,2,8,9,3,9,9,16,38,61,99,20,15,20.2020202020202,15.1515151515152,61.6161616161616,38.3838383838384
"200","28","2",0,3,3,3,4,8,6,4,3,3,10,7,2,9,5,3,33,43,76,3,18,3.94736842105263,23.6842105263158,56.5789473684211,43.4210526315789
"201","28","3",1,2,2,2,0,7,4,5,1,2,5,8,3,6,5,9,24,41,65,10,12,15.3846153846154,18.4615384615385,63.0769230769231,36.9230769230769
"202","28","4",3,2,2,1,1,6,0,4,2,1,5,3,2,2,4,3,22,22,44,6,11,13.6363636363636,25,50,50
"203","28","5",8,2,3,0,1,8,1,2,2,1,6,3,1,2,2,3,26,22,48,11,14,22.9166666666667,29.1666666666667,45.8333333333333,54.1666666666667
"204","28","6",0,0,2,3,3,5,4,1,1,4,6,2,2,3,1,4,21,23,44,4,11,9.09090909090909,25,52.2727272727273,47.7272727272727
"205","29","1",2,3,6,1,5,9,2,4,3,4,8,5,2,5,4,2,33,35,68,4,17,5.88235294117647,25,51.4705882352941,48.5294117647059
"206","29","2",1,2,3,1,1,9,5,3,1,2,8,7,2,6,3,4,27,34,61,5,17,8.19672131147541,27.8688524590164,55.7377049180328,44.2622950819672
"207","29","3",0,0,2,1,1,1,3,2,0,3,0,4,2,3,2,1,12,16,28,1,1,3.57142857142857,3.57142857142857,57.1428571428571,42.8571428571429
"208","29","4",5,1,1,1,2,1,1,2,2,1,2,1,1,2,2,0,17,11,28,5,3,17.8571428571429,10.7142857142857,39.2857142857143,60.7142857142857
"209","29","5",9,3,1,2,2,0,0,2,3,0,1,0,1,1,2,0,22,8,30,9,1,30,3.33333333333333,26.6666666666667,73.3333333333333
"210","29","6",11,7,6,2,5,0,2,0,7,1,0,0,2,0,0,0,35,11,46,11,0,23.9130434782609,0,23.9130434782609,76.0869565217391
"211","3","1",19,13,15,5,17,5,6,1,14,7,6,2,4,3,1,1,84,38,122,20,11,16.3934426229508,9.01639344262295,31.1475409836066,68.8524590163934
"212","3","2",2,5,8,8,8,15,8,9,5,11,14,9,8,8,9,10,64,76,140,12,29,8.57142857142857,20.7142857142857,54.2857142857143,45.7142857142857
"213","3","3",6,5,6,6,8,9,5,11,5,7,11,11,4,12,11,14,57,77,134,20,20,14.9253731343284,14.9253731343284,57.4626865671642,42.5373134328358
"214","3","4",9,7,7,8,7,7,5,8,7,8,7,5,8,5,8,5,58,56,114,14,14,12.280701754386,12.280701754386,49.1228070175439,50.8771929824561
"215","3","5",8,7,6,2,7,13,4,1,8,1,14,3,2,3,1,0,51,32,83,8,27,9.63855421686747,32.5301204819277,38.5542168674699,61.4457831325301
"216","3","6",1,2,3,2,3,12,2,8,2,3,12,8,3,8,8,19,35,64,99,20,24,20.2020202020202,24.2424242424242,64.6464646464647,35.3535353535354
"217","30","1",7,5,9,0,7,10,3,0,5,4,7,3,3,0,0,0,43,23,66,7,17,10.6060606060606,25.7575757575758,34.8484848484849,65.1515151515152
"218","30","2",2,3,5,1,3,11,3,2,3,3,10,3,3,2,2,0,32,27,59,2,21,3.38983050847458,35.5932203389831,45.7627118644068,54.2372881355932
"219","30","3",0,3,3,2,2,8,3,2,3,3,7,3,4,2,2,1,25,26,51,1,15,1.96078431372549,29.4117647058824,50.9803921568627,49.0196078431373
"220","30","4",3,3,3,1,3,3,1,0,3,1,3,0,1,0,0,0,20,8,28,3,6,10.7142857142857,21.4285714285714,28.5714285714286,71.4285714285714
"221","30","5",0,1,1,2,0,5,3,2,1,1,4,3,2,2,2,0,15,17,32,0,9,0,28.125,53.125,46.875
"222","30","6",2,4,2,2,1,2,2,1,3,1,1,1,3,0,1,3,18,14,32,5,3,15.625,9.375,43.75,56.25
"223","31","1",0,0,1,0,1,3,0,3,1,1,3,3,1,3,4,3,11,19,30,3,6,10,20,63.3333333333333,36.6666666666667
"224","31","2",0,1,1,2,1,3,2,2,0,2,3,2,2,2,2,0,14,14,28,0,6,0,21.4285714285714,50,50
"225","31","3",1,1,3,1,1,8,2,7,0,3,7,8,2,7,7,8,26,43,69,9,15,13.0434782608696,21.7391304347826,62.3188405797101,37.6811594202899
"226","31","4",0,0,1,3,2,8,3,4,0,4,9,4,2,5,4,3,21,34,55,3,17,5.45454545454545,30.9090909090909,61.8181818181818,38.1818181818182
"227","31","5",1,2,2,1,2,8,3,0,2,2,8,2,1,2,0,0,21,18,39,1,16,2.56410256410256,41.025641025641,46.1538461538462,53.8461538461538
"228","31","6",1,2,5,3,5,9,4,0,2,6,9,2,2,2,0,0,30,25,55,1,18,1.81818181818182,32.7272727272727,45.4545454545455,54.5454545454545
"229","32","1",5,3,3,7,6,8,8,1,3,8,10,2,5,4,1,0,43,34,77,5,18,6.49350649350649,23.3766233766234,44.1558441558442,55.8441558441558
"230","32","2",0,0,0,0,0,0,0,1,0,0,0,1,0,0,0,1,1,5,6,1,0,16.6666666666667,0,83.3333333333333,16.6666666666667
"231","32","3",0,0,0,0,0,0,0,0,0,0,0,0,0,0,0,0,1,0,1,0,0,0,0,0,100
"232","32","4",0,0,0,0,0,0,0,0,0,0,0,0,0,0,0,0,2,1,3,0,0,0,0,33.3333333333333,66.6666666666667
"233","32","5",1,1,1,0,0,2,0,0,0,0,1,0,0,0,0,0,6,3,9,1,3,11.1111111111111,33.3333333333333,33.3333333333333,66.6666666666667
"234","32","6",5,2,2,0,2,3,1,0,3,0,2,1,1,0,0,0,18,7,25,5,5,20,20,28,72
"235","33","1",6,4,6,5,6,5,8,3,4,7,5,5,5,5,3,0,44,36,80,6,10,7.5,12.5,45,55
"236","33","2",10,3,4,3,4,0,1,2,2,4,0,0,3,0,2,1,29,13,42,11,0,26.1904761904762,0,30.952380952381,69.0476190476191
"237","33","3",21,4,3,1,3,1,1,1,4,1,1,1,2,1,1,1,37,13,50,22,2,44,4,26,74
"238","33","4",0,1,4,0,2,3,1,2,1,2,1,3,1,1,2,2,14,15,29,2,4,6.89655172413793,13.7931034482759,51.7241379310345,48.2758620689655
"239","33","5",0,0,0,0,0,0,1,3,0,0,0,4,0,3,2,11,4,23,27,11,0,40.7407407407407,0,85.1851851851852,14.8148148148148
"240","33","6",0,0,0,0,0,0,0,0,0,0,0,0,0,0,0,0,1,1,2,0,0,0,0,50,50
"241","34","1",0,1,3,1,0,4,2,5,1,3,1,6,3,3,4,20,16,44,60,20,5,33.3333333333333,8.33333333333333,73.3333333333333,26.6666666666667
"242","34","2",2,1,0,2,1,1,1,2,1,1,2,1,1,1,1,22,10,33,43,24,3,55.8139534883721,6.97674418604651,76.7441860465116,23.2558139534884
"243","34","3",0,0,0,3,0,0,1,3,0,4,0,1,4,1,4,16,9,31,40,16,0,40,0,77.5,22.5
"244","34","4",0,0,1,1,0,1,1,3,0,2,0,3,2,2,3,23,7,38,45,23,1,51.1111111111111,2.22222222222222,84.4444444444444,15.5555555555556
"245","34","5",0,0,0,0,0,0,0,0,0,0,0,0,0,0,0,65,0,68,68,65,0,95.5882352941177,0,100,0
"246","34","6",0,0,0,0,0,0,0,0,0,0,0,0,0,0,0,54,0,57,57,54,0,94.7368421052632,0,100,0
"247","35","1",2,5,3,5,4,2,2,5,5,2,3,2,3,3,5,11,29,36,65,13,5,20,7.69230769230769,55.3846153846154,44.6153846153846
"248","35","2",0,0,1,1,0,2,2,4,0,2,1,5,2,4,5,32,11,53,64,32,3,50,4.6875,82.8125,17.1875
"249","35","3",0,0,0,0,0,0,0,3,0,0,0,3,0,3,3,34,3,46,49,34,0,69.3877551020408,0,93.8775510204082,6.12244897959184
"250","35","4",3,0,0,1,0,0,1,1,1,1,0,1,2,1,2,6,9,14,23,9,0,39.1304347826087,0,60.8695652173913,39.1304347826087
"251","35","5",0,0,0,0,0,2,0,3,0,0,2,3,0,3,2,4,5,17,22,4,4,18.1818181818182,18.1818181818182,77.2727272727273,22.7272727272727
"252","35","6",0,0,0,0,0,0,0,1,0,0,0,1,0,0,0,2,1,6,7,2,0,28.5714285714286,0,85.7142857142857,14.2857142857143
"253","37","1",2,4,4,2,3,4,4,1,3,2,3,3,2,2,1,0,25,18,43,2,7,4.65116279069767,16.2790697674419,41.8604651162791,58.1395348837209
"254","37","2",0,2,4,0,3,2,0,0,2,1,1,1,0,0,0,0,12,7,19,0,3,0,15.7894736842105,36.8421052631579,63.1578947368421
"255","37","3",0,0,0,0,0,0,0,0,0,0,0,0,0,0,0,0,1,1,2,0,0,0,0,50,50
"256","37","4",0,0,0,0,0,0,0,0,0,0,0,0,0,0,0,0,0,0,0,0,0,NA,NA,NA,NA
"257","37","5",0,0,0,0,0,0,0,0,0,0,0,0,0,0,0,0,0,0,0,0,0,NA,NA,NA,NA
"258","37","6",0,0,0,0,0,0,0,0,0,0,0,0,0,0,0,0,0,1,1,0,0,0,0,100,0
"259","38","1",0,0,0,1,0,0,2,2,0,1,1,2,1,3,2,2,7,13,20,2,1,10,5,65,35
"260","38","2",0,0,0,0,0,3,0,1,0,0,4,1,0,1,1,0,6,8,14,0,7,0,50,57.1428571428571,42.8571428571429
"261","38","3",0,1,0,0,0,0,0,0,1,0,0,0,0,0,0,0,3,2,5,0,0,0,0,40,60
"262","38","4",0,0,0,0,0,0,0,0,0,0,0,0,0,0,0,0,0,0,0,0,0,NA,NA,NA,NA
"263","38","5",0,0,0,0,0,0,0,0,0,0,0,0,0,0,0,0,0,0,0,0,0,NA,NA,NA,NA
"264","38","6",0,0,0,0,0,0,0,0,0,0,0,0,0,0,0,0,1,0,1,0,0,0,0,0,100
"265","39","1",0,1,2,2,2,3,3,8,1,3,3,9,2,10,9,9,22,48,70,9,6,12.8571428571429,8.57142857142857,68.5714285714286,31.4285714285714
"266","39","2",5,4,2,4,2,7,5,4,4,2,6,5,4,4,4,5,34,36,70,10,13,14.2857142857143,18.5714285714286,51.4285714285714,48.5714285714286
"267","39","3",2,1,2,1,2,3,4,1,1,2,3,4,1,4,1,0,17,18,35,2,6,5.71428571428571,17.1428571428571,51.4285714285714,48.5714285714286
"268","39","4",1,1,3,2,3,7,2,3,1,4,6,3,2,2,2,4,22,27,49,5,13,10.2040816326531,26.530612244898,55.1020408163265,44.8979591836735
"269","39","5",0,0,2,0,1,2,1,2,0,2,1,2,1,2,2,0,9,12,21,0,3,0,14.2857142857143,57.1428571428571,42.8571428571429
"270","39","6",0,0,1,0,0,1,0,0,0,1,0,1,0,0,0,0,3,4,7,0,1,0,14.2857142857143,57.1428571428571,42.8571428571429
"271","4","1",12,13,12,5,14,6,3,7,13,4,9,5,2,8,7,8,74,57,131,20,15,15.2671755725191,11.4503816793893,43.5114503816794,56.4885496183206
"272","4","2",14,10,10,3,10,8,4,3,11,3,8,4,3,4,3,2,65,38,103,16,16,15.5339805825243,15.5339805825243,36.8932038834951,63.1067961165049
"273","4","3",28,10,7,3,7,0,4,0,10,0,0,1,3,1,0,0,62,15,77,28,0,36.3636363636364,0,19.4805194805195,80.5194805194805
"274","4","4",20,5,5,4,5,1,5,0,5,4,1,1,4,1,0,0,48,16,64,20,2,31.25,3.125,25,75
"275","4","5",8,4,3,3,4,8,2,0,4,2,8,0,2,0,0,0,33,18,51,8,16,15.6862745098039,31.3725490196078,35.2941176470588,64.7058823529412
"276","4","6",6,6,9,1,9,2,2,0,6,5,2,1,2,0,0,0,37,17,54,6,4,11.1111111111111,7.40740740740741,31.4814814814815,68.5185185185185
"277","40","1",3,4,4,8,8,8,6,4,4,8,12,2,3,6,3,4,45,45,90,7,20,7.77777777777778,22.2222222222222,50,50
"278","40","2",1,2,2,2,2,11,3,2,2,2,11,2,2,3,2,2,26,28,54,3,22,5.55555555555556,40.7407407407407,51.8518518518519,48.1481481481481
"279","40","3",0,2,2,1,2,44,1,2,2,1,44,2,1,2,2,4,56,59,115,4,88,3.47826086956522,76.5217391304348,51.304347826087,48.695652173913
"280","40","4",1,1,2,0,2,64,1,0,1,1,64,1,0,1,0,0,72,70,142,1,128,0.704225352112676,90.1408450704225,49.2957746478873,50.7042253521127
"281","40","5",0,0,0,0,0,75,0,0,0,0,75,0,0,0,0,0,77,76,153,0,150,0,98.0392156862745,49.6732026143791,50.3267973856209
"282","40","6",0,0,2,0,2,62,0,0,0,2,62,0,0,0,0,0,67,66,133,0,124,0,93.2330827067669,49.6240601503759,50.3759398496241
"283","41","1",3,2,3,4,3,5,5,3,2,5,6,4,4,5,4,7,30,38,68,10,11,14.7058823529412,16.1764705882353,55.8823529411765,44.1176470588235
"284","41","2",3,3,4,0,1,10,3,4,3,1,6,7,3,3,3,19,28,48,76,22,16,28.9473684210526,21.0526315789474,63.1578947368421,36.8421052631579
"285","41","3",110,6,5,2,5,2,1,6,6,1,1,6,2,5,6,30,138,59,197,140,3,71.0659898477157,1.52284263959391,29.9492385786802,70.0507614213198
"286","41","4",25,12,13,6,15,9,7,4,12,6,11,5,3,7,3,42,91,92,183,67,20,36.6120218579235,10.9289617486339,50.2732240437158,49.7267759562842
"287","41","5",73,11,12,1,11,5,0,5,10,2,4,4,1,3,4,58,118,89,207,131,9,63.2850241545894,4.34782608695652,42.9951690821256,57.0048309178744
"288","41","6",27,8,13,3,13,16,1,10,8,8,15,9,3,8,10,36,92,99,191,63,31,32.9842931937173,16.2303664921466,51.8324607329843,48.1675392670157
"289","42","1",8,5,9,12,7,20,14,20,5,16,19,22,14,21,20,23,97,141,238,31,39,13.0252100840336,16.3865546218487,59.2436974789916,40.7563025210084
"290","42","2",2,3,6,5,5,12,3,16,3,7,11,14,5,13,15,151,52,222,274,153,23,55.8394160583942,8.39416058394161,81.021897810219,18.978102189781
"291","42","3",0,2,2,4,1,4,2,18,2,4,3,16,5,16,19,167,34,234,268,167,7,62.3134328358209,2.61194029850746,87.3134328358209,12.6865671641791
"292","42","4",0,0,1,3,2,8,4,10,0,4,9,11,2,12,10,139,28,190,218,139,17,63.7614678899083,7.79816513761468,87.1559633027523,12.8440366972477
"293","42","5",0,0,1,0,0,9,3,11,0,1,7,14,1,12,11,131,25,179,204,131,16,64.2156862745098,7.84313725490196,87.7450980392157,12.2549019607843
"294","42","6",0,0,1,1,0,1,0,11,0,2,0,10,2,9,11,123,15,159,174,123,1,70.6896551724138,0.574712643678161,91.3793103448276,8.62068965517241
"295","43","1",3,5,9,3,8,12,0,12,4,7,11,9,3,8,11,30,52,86,138,33,23,23.9130434782609,16.6666666666667,62.3188405797101,37.6811594202899
"296","43","2",0,4,4,4,3,6,7,9,4,4,5,12,4,11,8,19,37,70,107,19,11,17.7570093457944,10.2803738317757,65.4205607476636,34.5794392523364
"297","43","3",3,2,2,0,2,2,0,4,2,0,2,4,0,3,3,48,15,65,80,51,4,63.75,5,81.25,18.75
"298","43","4",0,0,0,1,0,3,1,3,0,1,3,2,1,2,2,39,8,53,61,39,6,63.9344262295082,9.83606557377049,86.8852459016394,13.1147540983607
"299","43","5",0,0,0,0,0,0,1,1,0,0,0,1,0,1,0,27,2,32,34,27,0,79.4117647058823,0,94.1176470588235,5.88235294117647
"300","43","6",1,2,0,2,0,0,2,3,1,0,0,4,1,4,3,53,11,68,79,54,0,68.3544303797468,0,86.0759493670886,13.9240506329114
"301","44","1",10,6,8,8,10,16,8,10,7,10,18,10,7,11,10,10,79,83,162,20,34,12.3456790123457,20.9876543209877,51.2345679012346,48.7654320987654
"302","44","2",10,8,11,5,9,34,6,3,8,7,33,4,6,3,3,0,88,65,153,10,67,6.5359477124183,43.7908496732026,42.483660130719,57.516339869281
"303","44","3",7,5,6,4,8,24,3,1,5,5,26,0,2,2,1,0,60,42,102,7,50,6.86274509803922,49.0196078431373,41.1764705882353,58.8235294117647
"304","44","4",3,3,5,1,5,54,2,0,3,2,54,1,0,2,0,0,74,64,138,3,108,2.17391304347826,78.2608695652174,46.3768115942029,53.6231884057971
"305","44","5",4,1,4,0,4,61,1,1,1,3,62,2,0,3,2,2,78,76,154,6,123,3.8961038961039,79.8701298701299,49.3506493506493,50.6493506493507
"306","44","6",0,0,3,1,2,44,3,0,0,4,43,3,2,2,1,0,54,57,111,0,87,0,78.3783783783784,51.3513513513514,48.6486486486486
"307","45","1",28,12,12,12,13,15,11,5,12,12,17,4,11,6,6,4,110,73,183,32,32,17.4863387978142,17.4863387978142,39.8907103825137,60.1092896174863
"308","45","2",51,15,17,4,16,11,4,2,15,6,10,2,5,1,2,0,123,41,164,51,21,31.0975609756098,12.8048780487805,25,75
"309","45","3",12,9,5,8,5,10,13,6,9,5,9,11,9,10,6,4,70,64,134,16,19,11.9402985074627,14.1791044776119,47.7611940298507,52.2388059701493
"310","45","4",20,9,9,6,8,9,7,8,8,6,8,10,6,9,8,5,77,62,139,25,17,17.9856115107914,12.2302158273381,44.6043165467626,55.3956834532374
"311","45","5",21,10,9,4,9,4,0,7,9,3,4,3,3,4,7,13,65,48,113,34,8,30.0884955752212,7.07964601769912,42.4778761061947,57.5221238938053
"312","45","6",25,8,4,7,5,6,6,3,8,3,6,2,6,3,3,9,65,42,107,34,12,31.7757009345794,11.214953271028,39.2523364485981,60.7476635514019
"313","46","1",5,8,11,10,9,25,11,14,8,13,23,15,13,13,15,20,95,121,216,25,48,11.5740740740741,22.2222222222222,56.0185185185185,43.9814814814815
"314","46","2",2,2,1,6,2,25,5,15,2,5,26,14,5,15,15,42,59,126,185,44,51,23.7837837837838,27.5675675675676,68.1081081081081,31.8918918918919
"315","46","3",0,1,2,5,4,16,7,14,1,6,18,16,4,17,14,41,51,118,169,41,34,24.2603550295858,20.1183431952663,69.8224852071006,30.1775147928994
"316","46","4",0,1,3,6,2,8,6,13,1,8,6,13,7,11,13,59,40,120,160,59,14,36.875,8.75,75,25
"317","46","5",4,3,3,4,2,8,0,12,3,4,7,8,6,7,13,66,38,115,153,70,15,45.7516339869281,9.80392156862745,75.1633986928105,24.8366013071895
"318","46","6",2,3,5,3,4,10,7,9,3,5,9,13,4,12,10,58,44,116,160,60,19,37.5,11.875,72.5,27.5
"319","47","1",5,5,12,15,13,24,16,18,5,22,25,19,13,21,18,28,109,153,262,33,49,12.5954198473282,18.7022900763359,58.3969465648855,41.6030534351145
"320","47","2",16,12,13,11,15,26,10,10,13,12,28,9,10,11,11,22,116,116,232,38,54,16.3793103448276,23.2758620689655,50,50
"321","47","3",8,9,10,10,8,15,13,8,10,11,13,11,13,9,9,20,84,96,180,28,28,15.5555555555556,15.5555555555556,53.3333333333333,46.6666666666667
"322","47","4",3,6,8,4,5,19,6,7,6,6,15,9,7,6,7,10,59,68,127,13,34,10.2362204724409,26.7716535433071,53.5433070866142,46.4566929133858
"323","47","5",1,2,10,4,10,25,8,5,2,12,25,9,4,10,6,11,66,81,147,12,50,8.16326530612245,34.0136054421769,55.1020408163265,44.8979591836735
"324","47","6",3,9,15,7,13,39,16,6,9,13,38,15,9,13,6,1,110,105,215,4,77,1.86046511627907,35.8139534883721,48.8372093023256,51.1627906976744
"325","48","1",5,3,4,8,5,2,4,17,3,9,3,14,6,15,17,35,49,104,153,40,5,26.1437908496732,3.26797385620915,67.9738562091503,32.0261437908497
"326","48","2",0,3,6,3,3,8,5,13,3,6,6,15,5,13,13,20,43,82,125,20,14,16,11.2,65.6,34.4
"327","48","3",2,3,4,3,1,6,6,10,2,5,3,13,6,10,10,8,37,58,95,10,9,10.5263157894737,9.47368421052632,61.0526315789474,38.9473684210526
"328","48","4",7,3,3,4,3,10,7,3,3,4,10,6,4,6,3,26,40,65,105,33,20,31.4285714285714,19.047619047619,61.9047619047619,38.0952380952381
"329","48","5",7,7,6,5,6,3,6,2,6,4,3,3,4,3,1,69,42,96,138,76,6,55.0724637681159,4.34782608695652,69.5652173913043,30.4347826086957
"330","48","6",24,7,7,6,8,13,7,6,7,6,14,8,4,9,6,15,79,71,150,39,27,26,18,47.3333333333333,52.6666666666667
"331","5","1",2,2,4,1,3,4,2,12,1,3,3,13,1,12,11,71,30,118,148,73,7,49.3243243243243,4.72972972972973,79.7297297297297,20.2702702702703
"332","5","2",0,0,0,0,0,0,0,2,0,0,0,2,0,2,2,170,2,179,181,170,0,93.9226519337017,0,98.8950276243094,1.10497237569061
"333","5","3",0,0,0,0,0,1,2,3,0,0,1,5,0,5,3,127,6,144,150,127,2,84.6666666666667,1.33333333333333,96,4
"334","5","4",0,0,0,0,0,0,0,1,0,0,0,1,0,1,1,97,1,103,104,97,0,93.2692307692308,0,99.0384615384615,0.961538461538462
"335","5","5",0,0,0,0,0,0,0,0,0,0,0,0,0,0,0,75,0,78,78,75,0,96.1538461538462,0,100,0
"336","5","6",0,0,0,0,0,0,0,0,0,0,0,0,0,0,0,56,0,59,59,56,0,94.9152542372881,0,100,0
"337","57","1",58,6,3,3,5,1,3,1,7,0,2,1,2,2,1,1,83,16,99,59,3,59.5959595959596,3.03030303030303,16.1616161616162,83.8383838383838
"338","57","2",67,2,2,0,2,1,0,0,2,0,1,0,0,0,0,0,77,3,80,67,2,83.75,2.5,3.75,96.25
"339","57","3",69,2,1,1,1,0,0,1,2,0,0,0,1,0,1,0,78,4,82,69,0,84.1463414634146,0,4.8780487804878,95.1219512195122
"340","57","4",24,1,1,0,1,0,0,0,1,0,0,0,0,0,0,0,30,1,31,24,0,77.4193548387097,0,3.2258064516129,96.7741935483871
"341","57","5",16,1,1,0,1,0,0,0,1,0,0,0,0,0,0,0,22,1,23,16,0,69.5652173913043,0,4.34782608695652,95.6521739130435
"342","57","6",29,2,2,0,2,0,0,0,2,0,0,0,0,0,0,0,38,2,40,29,0,72.5,0,5,95
"343","58","1",4,3,9,6,9,10,7,6,4,12,10,7,7,7,6,7,57,60,117,11,20,9.4017094017094,17.0940170940171,51.2820512820513,48.7179487179487
"344","58","2",6,5,2,4,2,3,6,2,5,2,3,3,5,3,2,0,32,24,56,6,6,10.7142857142857,10.7142857142857,42.8571428571429,57.1428571428571
"345","58","3",0,3,5,1,5,3,2,0,3,4,3,1,1,1,0,0,21,14,35,0,6,0,17.1428571428571,40,60
"346","58","4",5,2,1,0,2,3,1,0,2,0,4,1,0,1,0,0,16,9,25,5,7,20,28,36,64
"347","58","5",1,1,2,0,1,1,0,0,1,1,0,1,0,0,0,0,7,5,12,1,1,8.33333333333333,8.33333333333333,41.6666666666667,58.3333333333333
"348","58","6",0,0,0,0,0,2,0,2,0,0,3,2,0,3,2,4,6,15,21,4,5,19.047619047619,23.8095238095238,71.4285714285714,28.5714285714286
"349","59","1",2,3,5,5,5,7,10,6,3,6,7,11,4,11,5,9,43,59,102,11,14,10.7843137254902,13.7254901960784,57.843137254902,42.156862745098
"350","59","2",1,2,5,4,4,4,4,2,2,7,3,2,5,0,1,2,26,25,51,3,7,5.88235294117647,13.7254901960784,49.0196078431373,50.9803921568627
"351","59","3",0,0,0,0,0,1,0,1,0,1,1,1,1,1,2,5,4,13,17,5,2,29.4117647058824,11.7647058823529,76.4705882352941,23.5294117647059
"352","59","4",0,0,1,0,0,1,0,0,0,1,0,0,0,0,0,0,3,3,6,0,1,0,16.6666666666667,50,50
"353","59","5",0,0,0,1,0,0,0,1,0,1,0,0,1,0,1,0,3,5,8,0,0,0,0,62.5,37.5
"354","59","6",1,1,1,0,0,1,0,2,2,0,0,1,2,0,2,1,9,8,17,2,1,11.7647058823529,5.88235294117647,47.0588235294118,52.9411764705882
"355","6","1",0,0,0,0,0,0,0,0,0,0,0,0,0,0,0,0,3,0,3,0,0,0,0,0,100
"356","6","2",0,1,1,0,0,1,1,0,0,0,0,1,0,0,0,0,5,3,8,0,1,0,12.5,37.5,62.5
"357","6","3",0,0,0,0,0,0,0,0,0,0,0,0,0,0,0,0,0,0,0,0,0,NA,NA,NA,NA
"358","6","4",0,0,0,0,0,0,0,0,0,0,0,0,0,0,0,0,3,0,3,0,0,0,0,0,100
"359","6","5",0,0,0,0,0,0,0,0,0,0,0,0,0,0,0,0,0,0,0,0,0,NA,NA,NA,NA
"360","6","6",0,0,0,0,0,0,0,0,0,0,0,0,0,0,0,0,0,0,0,0,0,NA,NA,NA,NA
"361","60","1",7,9,8,5,9,11,3,4,9,5,12,2,4,3,4,3,58,43,101,10,23,9.9009900990099,22.7722772277228,42.5742574257426,57.4257425742574
"362","60","2",6,5,16,3,10,16,10,4,5,14,10,11,10,5,5,8,72,69,141,14,26,9.9290780141844,18.4397163120567,48.936170212766,51.063829787234
"363","60","3",1,1,0,5,1,12,5,9,1,4,13,9,4,11,9,35,35,88,123,36,25,29.2682926829268,20.3252032520325,71.5447154471545,28.4552845528455
"364","60","4",1,2,2,5,0,5,7,6,1,6,3,8,7,6,6,13,30,51,81,14,8,17.2839506172839,9.87654320987654,62.962962962963,37.037037037037
"365","60","5",5,1,2,0,3,7,0,3,2,1,8,2,0,3,3,6,24,25,49,11,15,22.4489795918367,30.6122448979592,51.0204081632653,48.9795918367347
"366","60","6",9,5,5,5,6,14,6,1,5,5,15,2,4,3,1,0,54,35,89,9,29,10.1123595505618,32.5842696629214,39.3258426966292,60.6741573033708
"367","61","1",0,0,2,3,2,8,2,5,0,6,8,4,4,3,5,5,24,36,60,5,16,8.33333333333333,26.6666666666667,60,40
"368","61","2",0,0,2,4,2,5,7,8,0,6,5,11,4,10,7,21,28,67,95,21,10,22.1052631578947,10.5263157894737,70.5263157894737,29.4736842105263
"369","61","3",0,1,3,0,1,6,2,6,1,2,4,8,2,5,5,22,19,52,71,22,10,30.9859154929577,14.0845070422535,73.2394366197183,26.7605633802817
"370","61","4",0,1,0,1,0,4,0,3,1,0,4,2,1,3,4,15,10,32,42,15,8,35.7142857142857,19.047619047619,76.1904761904762,23.8095238095238
"371","61","5",0,0,0,2,0,0,2,4,0,2,0,4,3,4,5,5,10,24,34,5,0,14.7058823529412,0,70.5882352941177,29.4117647058824
"372","61","6",0,0,0,0,0,2,3,4,0,0,2,7,0,7,4,3,9,26,35,3,4,8.57142857142857,11.4285714285714,74.2857142857143,25.7142857142857
"373","62","1",0,0,2,2,1,6,2,4,0,4,5,3,3,3,4,3,18,27,45,3,11,6.66666666666667,24.4444444444444,60,40
"374","62","2",12,4,5,3,3,4,3,1,4,4,2,1,4,0,1,0,36,18,54,12,6,22.2222222222222,11.1111111111111,33.3333333333333,66.6666666666667
"375","62","3",2,3,3,4,5,2,0,5,4,4,3,1,3,2,5,1,27,23,50,3,5,6,10,46,54
"376","62","4",1,2,3,2,2,2,0,3,3,2,1,1,3,0,3,5,18,18,36,6,3,16.6666666666667,8.33333333333333,50,50
"377","62","5",11,4,6,0,6,7,0,0,5,2,7,0,1,0,0,0,37,15,52,11,14,21.1538461538462,26.9230769230769,28.8461538461538,71.1538461538462
"378","62","6",9,3,3,0,2,2,1,0,2,1,1,1,1,0,0,0,22,7,29,9,3,31.0344827586207,10.3448275862069,24.1379310344828,75.8620689655172
"379","63","1",0,1,1,1,1,2,1,7,1,1,2,7,1,6,7,131,15,158,173,131,4,75.7225433526011,2.3121387283237,91.3294797687861,8.67052023121387
"380","63","2",0,0,0,0,0,0,0,5,0,0,0,5,0,5,5,141,5,159,164,141,0,85.9756097560976,0,96.9512195121951,3.04878048780488
"381","63","3",0,0,0,0,0,0,0,0,0,0,0,0,0,0,0,124,0,127,127,124,0,97.6377952755905,0,100,0
"382","63","4",0,0,0,0,0,0,0,1,0,0,0,1,0,1,1,86,1,92,93,86,0,92.4731182795699,0,98.9247311827957,1.0752688172043
"383","63","5",0,0,0,1,0,0,1,4,0,1,0,4,1,4,4,49,6,66,72,49,0,68.0555555555556,0,91.6666666666667,8.33333333333333
"384","63","6",0,0,0,1,0,2,1,7,0,1,2,7,1,7,7,27,11,55,66,27,4,40.9090909090909,6.06060606060606,83.3333333333333,16.6666666666667
"385","64","1",22,9,12,3,14,6,4,1,10,6,7,2,2,3,1,1,74,32,106,23,13,21.6981132075472,12.2641509433962,30.188679245283,69.811320754717
"386","64","2",15,11,13,4,14,6,4,1,11,6,7,1,3,2,1,0,70,32,102,15,13,14.7058823529412,12.7450980392157,31.3725490196078,68.6274509803922
"387","64","3",0,1,4,2,3,8,5,4,1,4,7,7,3,6,4,2,29,35,64,2,15,3.125,23.4375,54.6875,45.3125
"388","64","4",1,4,4,3,4,7,4,5,4,3,7,6,2,7,5,10,33,46,79,11,14,13.9240506329114,17.7215189873418,58.2278481012658,41.7721518987342
"389","64","5",0,1,4,2,2,11,4,3,1,5,9,5,3,4,3,0,28,32,60,0,20,0,33.3333333333333,53.3333333333333,46.6666666666667
"390","64","6",0,0,0,3,3,8,4,5,0,3,11,7,0,9,5,2,24,39,63,2,19,3.17460317460317,30.1587301587302,61.9047619047619,38.0952380952381
"391","65","1",8,2,5,1,2,4,3,4,1,4,2,6,3,4,4,9,31,34,65,17,6,26.1538461538462,9.23076923076923,52.3076923076923,47.6923076923077
"392","65","2",0,0,0,0,0,0,0,4,0,0,0,4,0,4,4,80,4,95,99,80,0,80.8080808080808,0,95.959595959596,4.04040404040404
"393","65","3",0,1,3,2,2,8,3,5,1,4,7,6,3,6,6,12,25,47,72,12,15,16.6666666666667,20.8333333333333,65.2777777777778,34.7222222222222
"394","65","4",0,0,0,2,0,3,1,7,0,2,3,6,2,6,7,15,14,43,57,15,6,26.3157894736842,10.5263157894737,75.4385964912281,24.5614035087719
"395","65","5",0,0,1,1,0,3,1,5,0,2,2,5,2,3,4,15,11,36,47,15,5,31.9148936170213,10.6382978723404,76.5957446808511,23.4042553191489
"396","65","6",0,0,0,0,0,1,0,2,0,0,1,2,0,2,2,26,3,36,39,26,2,66.6666666666667,5.12820512820513,92.3076923076923,7.69230769230769
"397","66","1",1,4,3,6,6,2,2,5,4,5,5,1,4,4,6,12,31,42,73,13,7,17.8082191780822,9.58904109589041,57.5342465753425,42.4657534246575
"398","66","2",0,0,0,3,0,2,2,8,0,3,2,7,3,7,8,28,15,61,76,28,4,36.8421052631579,5.26315789473684,80.2631578947368,19.7368421052632
"399","66","3",0,0,0,1,0,1,1,3,0,1,1,3,1,2,2,22,6,35,41,22,2,53.6585365853659,4.8780487804878,85.3658536585366,14.6341463414634
"400","66","4",0,0,0,0,0,0,1,1,0,0,0,2,0,2,2,32,3,40,43,32,0,74.4186046511628,0,93.0232558139535,6.97674418604651
"401","66","5",0,0,0,0,0,1,0,2,0,0,1,2,0,2,2,30,3,40,43,30,2,69.7674418604651,4.65116279069767,93.0232558139535,6.97674418604651
"402","66","6",0,0,0,1,1,0,0,1,0,1,1,0,0,1,1,30,3,37,40,30,1,75,2.5,92.5,7.5
"403","67","1",25,6,8,2,7,3,3,0,6,4,3,1,3,0,0,0,56,18,74,25,6,33.7837837837838,8.10810810810811,24.3243243243243,75.6756756756757
"404","67","2",24,9,9,2,8,5,2,1,8,2,4,1,3,0,1,2,62,22,84,26,9,30.952380952381,10.7142857142857,26.1904761904762,73.8095238095238
"405","67","3",24,5,3,3,4,3,5,0,6,1,3,2,3,2,0,0,50,17,67,24,6,35.8208955223881,8.95522388059701,25.3731343283582,74.6268656716418
"406","67","4",18,5,8,2,8,2,3,2,6,4,2,3,2,3,2,1,51,23,74,19,4,25.6756756756757,5.40540540540541,31.0810810810811,68.9189189189189
"407","67","5",19,7,7,0,7,3,2,0,7,0,2,2,1,1,0,0,47,14,61,19,5,31.1475409836066,8.19672131147541,22.9508196721311,77.0491803278689
"408","67","6",4,4,2,5,4,1,3,3,5,3,2,1,4,2,3,3,29,23,52,7,3,13.4615384615385,5.76923076923077,44.2307692307692,55.7692307692308
"409","68","1",0,1,1,4,2,4,3,4,1,4,5,3,3,3,3,1,19,26,45,1,9,2.22222222222222,20,57.7777777777778,42.2222222222222
"410","68","2",0,0,0,0,0,0,0,0,0,0,0,0,0,0,0,0,0,0,0,0,0,NA,NA,NA,NA
"411","68","3",0,0,0,0,0,0,0,0,0,0,0,0,0,0,0,0,0,1,1,0,0,0,0,100,0
"412","68","4",0,0,0,0,0,0,0,0,0,0,0,0,0,0,0,0,0,0,0,0,0,NA,NA,NA,NA
"413","68","5",0,0,0,0,0,0,0,0,0,0,0,0,0,0,0,0,0,0,0,0,0,NA,NA,NA,NA
"414","68","6",0,0,0,0,0,0,0,0,0,0,0,0,0,0,0,0,0,0,0,0,0,NA,NA,NA,NA
"415","69","1",5,7,7,3,4,19,3,5,7,3,17,5,5,3,5,3,55,49,104,8,36,7.69230769230769,34.6153846153846,47.1153846153846,52.8846153846154
"416","69","2",30,12,16,0,14,6,1,0,12,4,5,1,1,0,0,0,81,24,105,30,11,28.5714285714286,10.4761904761905,22.8571428571429,77.1428571428571
"417","69","3",18,9,11,2,9,5,3,1,8,5,3,2,4,0,1,1,60,25,85,19,8,22.3529411764706,9.41176470588235,29.4117647058824,70.5882352941177
"418","69","4",30,6,4,1,4,0,1,1,6,0,0,1,1,1,1,0,49,11,60,30,0,50,0,18.3333333333333,81.6666666666667
"419","69","5",43,3,3,0,3,0,0,0,3,0,0,0,0,0,0,0,55,3,58,43,0,74.1379310344828,0,5.17241379310345,94.8275862068966
"420","69","6",34,7,7,1,6,3,1,0,7,0,3,0,1,0,0,0,61,12,73,34,6,46.5753424657534,8.21917808219178,16.4383561643836,83.5616438356164
"421","7","1",3,1,2,1,1,3,1,1,2,2,2,1,3,0,2,0,16,12,28,3,5,10.7142857142857,17.8571428571429,42.8571428571429,57.1428571428571
"422","7","2",0,0,2,2,2,4,4,1,0,4,4,3,2,3,1,1,16,20,36,1,8,2.77777777777778,22.2222222222222,55.5555555555556,44.4444444444444
"423","7","3",0,1,1,3,1,5,3,3,1,2,5,3,2,3,2,2,17,23,40,2,10,5,25,57.5,42.5
"424","7","4",3,2,2,4,3,5,5,0,3,4,5,1,4,1,0,0,27,18,45,3,10,6.66666666666667,22.2222222222222,40,60
"425","7","5",0,2,2,3,1,4,3,4,2,3,3,3,4,3,4,2,20,26,46,2,7,4.34782608695652,15.2173913043478,56.5217391304348,43.4782608695652
"426","7","6",2,2,4,0,4,6,2,0,3,2,5,2,1,1,0,0,23,14,37,2,11,5.40540540540541,29.7297297297297,37.8378378378378,62.1621621621622
"427","70","1",4,3,4,3,5,9,2,4,3,4,10,3,2,4,4,8,35,40,75,12,19,16,25.3333333333333,53.3333333333333,46.6666666666667
"428","70","2",4,3,4,5,5,6,6,2,3,7,7,2,5,3,2,5,37,35,72,9,13,12.5,18.0555555555556,48.6111111111111,51.3888888888889
"429","70","3",3,3,3,1,3,2,1,0,3,0,2,0,0,1,0,0,17,8,25,3,4,12,16,32,68
"430","70","4",0,0,0,0,0,0,0,0,0,0,0,0,0,0,0,0,2,0,2,0,0,0,0,0,100
"431","70","5",1,0,0,0,0,0,0,0,1,0,0,0,0,0,0,0,4,1,5,1,0,20,0,20,80
"432","70","6",1,1,3,0,3,4,0,0,1,2,5,0,0,0,0,0,14,9,23,1,9,4.34782608695652,39.1304347826087,39.1304347826087,60.8695652173913
"433","71","1",0,2,3,0,2,6,3,0,2,1,5,3,2,2,1,3,18,20,38,3,11,7.89473684210526,28.9473684210526,52.6315789473684,47.3684210526316
"434","71","2",0,0,0,1,0,3,1,1,0,1,3,1,1,1,1,2,8,11,19,2,6,10.5263157894737,31.5789473684211,57.8947368421053,42.1052631578947
"435","71","3",2,1,1,0,1,3,0,0,1,0,3,0,0,0,0,0,9,6,15,2,6,13.3333333333333,40,40,60
"436","71","4",1,1,1,0,0,2,0,0,0,0,1,0,0,0,0,0,6,3,9,1,3,11.1111111111111,33.3333333333333,33.3333333333333,66.6666666666667
"437","71","5",0,0,0,1,1,0,2,0,0,2,0,1,1,1,0,0,6,6,12,0,0,0,0,50,50
"438","71","6",0,0,2,2,2,5,3,2,0,4,5,3,1,3,2,4,17,24,41,4,10,9.75609756097561,24.390243902439,58.5365853658537,41.4634146341463
"439","72","1",7,3,5,4,5,9,5,1,4,6,9,2,4,2,1,0,42,28,70,7,18,10,25.7142857142857,40,60
"440","72","2",18,8,8,4,10,15,6,0,9,4,17,2,3,3,0,0,72,38,110,18,32,16.3636363636364,29.0909090909091,34.5454545454545,65.4545454545455
"441","72","3",23,8,8,3,9,12,4,0,9,2,13,1,2,2,0,0,70,29,99,23,25,23.2323232323232,25.2525252525253,29.2929292929293,70.7070707070707
"442","72","4",13,11,7,5,7,8,2,4,10,1,8,1,4,2,4,3,58,35,93,16,16,17.2043010752688,17.2043010752688,37.6344086021505,62.3655913978495
"443","72","5",16,9,10,3,10,8,4,0,10,4,7,1,4,0,0,0,63,26,89,16,15,17.9775280898876,16.8539325842697,29.2134831460674,70.7865168539326
"444","72","6",29,7,9,1,9,4,2,0,6,3,4,1,1,1,0,0,63,17,80,29,8,36.25,10,21.25,78.75
"445","73","1",2,2,2,1,2,2,1,0,2,1,2,0,1,0,0,0,15,6,21,2,4,9.52380952380952,19.047619047619,28.5714285714286,71.4285714285714
"446","73","2",0,0,1,0,1,2,1,0,0,1,2,1,0,1,0,0,7,6,13,0,4,0,30.7692307692308,46.1538461538462,53.8461538461538
"447","73","3",0,0,0,0,0,0,0,0,0,0,0,0,0,0,0,0,0,0,0,0,0,NA,NA,NA,NA
"448","73","4",0,0,0,0,0,0,0,0,0,0,0,0,0,0,0,0,0,0,0,0,0,NA,NA,NA,NA
"449","73","5",0,0,0,0,0,0,0,0,0,0,0,0,0,0,0,0,0,0,0,0,0,NA,NA,NA,NA
"450","73","6",0,0,0,0,0,0,0,0,0,0,0,0,0,0,0,0,0,0,0,0,0,NA,NA,NA,NA
"451","74","1",2,3,7,2,6,8,4,4,3,6,8,6,3,5,4,2,38,38,76,4,16,5.26315789473684,21.0526315789474,50,50
"452","74","2",0,0,0,0,0,0,0,0,0,0,0,0,0,0,0,0,1,1,2,0,0,0,0,50,50
"453","74","3",0,0,0,0,0,0,0,1,0,0,0,1,0,1,1,47,1,53,54,47,0,87.037037037037,0,98.1481481481482,1.85185185185185
"454","74","4",3,1,2,1,0,3,3,2,1,2,2,4,3,3,3,21,17,40,57,24,5,42.1052631578947,8.7719298245614,70.1754385964912,29.8245614035088
"455","74","5",3,1,2,1,2,0,1,0,1,2,0,0,1,0,0,0,11,6,17,3,0,17.6470588235294,0,35.2941176470588,64.7058823529412
"456","74","6",0,0,0,0,0,0,0,3,0,0,0,4,0,4,4,18,4,32,36,18,0,50,0,88.8888888888889,11.1111111111111
"457","75","1",0,2,4,2,3,2,3,3,2,4,1,4,3,2,2,1,19,22,41,1,3,2.4390243902439,7.31707317073171,53.6585365853659,46.3414634146341
"458","75","2",28,10,9,3,8,9,6,3,10,3,8,5,5,4,3,0,78,39,117,28,17,23.9316239316239,14.5299145299145,33.3333333333333,66.6666666666667
"459","75","3",7,9,10,3,10,10,4,6,8,4,10,7,3,7,6,6,61,52,113,13,20,11.5044247787611,17.6991150442478,46.0176991150442,53.9823008849558
"460","75","4",4,5,6,5,7,11,4,6,5,6,11,5,4,6,6,1,49,46,95,5,22,5.26315789473684,23.1578947368421,48.4210526315789,51.5789473684211
"461","75","5",11,6,5,6,6,2,6,2,6,5,4,2,5,4,2,0,46,29,75,11,6,14.6666666666667,8,38.6666666666667,61.3333333333333
"462","75","6",4,2,3,6,4,5,8,2,2,8,6,4,6,5,2,1,36,35,71,5,11,7.04225352112676,15.4929577464789,49.2957746478873,50.7042253521127
"463","76","1",5,2,3,2,2,7,2,4,2,3,6,4,3,3,4,2,29,28,57,7,13,12.280701754386,22.8070175438597,49.1228070175439,50.8771929824561
"464","76","2",4,1,3,3,4,32,4,0,2,5,33,1,3,1,0,0,54,45,99,4,65,4.04040404040404,65.6565656565657,45.4545454545455,54.5454545454545
"465","76","3",10,4,4,3,5,10,4,0,4,3,11,1,2,2,0,0,42,24,66,10,21,15.1515151515152,31.8181818181818,36.3636363636364,63.6363636363636
"466","76","4",0,0,0,1,0,8,1,1,0,1,9,1,0,2,1,1,13,16,29,1,17,3.44827586206897,58.6206896551724,55.1724137931034,44.8275862068966
"467","76","5",3,3,3,0,2,10,0,0,3,0,10,0,0,0,0,0,23,14,37,3,20,8.10810810810811,54.0540540540541,37.8378378378378,62.1621621621622
"468","76","6",1,0,0,0,1,2,0,1,1,0,3,1,0,1,1,1,8,8,16,2,5,12.5,31.25,50,50
"469","78","1",3,6,7,4,8,12,4,2,6,4,13,2,2,3,2,3,47,37,84,6,25,7.14285714285714,29.7619047619048,44.0476190476191,55.9523809523809
"470","78","2",4,1,2,0,1,8,2,1,1,1,7,3,1,2,1,1,20,19,39,5,15,12.8205128205128,38.4615384615385,48.7179487179487,51.2820512820513
"471","78","3",0,0,0,0,0,6,0,3,0,0,7,3,0,4,3,3,11,21,32,3,13,9.375,40.625,65.625,34.375
"472","78","4",0,0,0,1,1,9,1,2,0,1,10,2,0,2,1,2,14,21,35,2,19,5.71428571428571,54.2857142857143,60,40
"473","78","5",0,0,1,1,0,7,1,7,0,2,6,6,2,6,7,14,18,45,63,14,13,22.2222222222222,20.6349206349206,71.4285714285714,28.5714285714286
"474","78","6",0,0,0,1,2,10,1,2,1,1,11,2,0,3,2,2,19,22,41,2,21,4.8780487804878,51.219512195122,53.6585365853659,46.3414634146341
"475","79","1",27,14,11,9,16,7,11,5,14,7,11,7,5,11,5,2,102,63,165,29,18,17.5757575757576,10.9090909090909,38.1818181818182,61.8181818181818
"476","79","2",5,4,6,6,6,7,6,13,4,9,7,13,7,12,13,29,55,95,150,34,14,22.6666666666667,9.33333333333333,63.3333333333333,36.6666666666667
"477","79","3",1,3,5,7,5,20,7,8,3,8,20,8,6,8,7,19,56,82,138,20,40,14.4927536231884,28.9855072463768,59.4202898550725,40.5797101449275
"478","79","4",0,1,2,2,2,6,5,10,1,3,6,13,2,13,10,29,29,79,108,29,12,26.8518518518519,11.1111111111111,73.1481481481482,26.8518518518519
"479","79","5",0,1,5,1,0,17,8,2,1,4,13,9,5,5,2,7,36,47,83,7,30,8.43373493975904,36.144578313253,56.6265060240964,43.3734939759036
"480","79","6",0,1,4,2,3,18,4,4,1,5,17,6,2,5,3,3,36,45,81,3,35,3.7037037037037,43.2098765432099,55.5555555555556,44.4444444444444
"481","8","1",0,1,3,2,3,14,4,1,0,4,14,3,1,4,1,1,29,30,59,1,28,1.69491525423729,47.4576271186441,50.8474576271186,49.1525423728814
"482","8","2",0,0,1,2,3,24,3,1,0,4,26,1,1,3,1,4,36,41,77,4,50,5.19480519480519,64.9350649350649,53.2467532467532,46.7532467532468
"483","8","3",0,0,1,0,0,15,1,1,0,1,14,2,1,2,2,5,19,29,48,5,29,10.4166666666667,60.4166666666667,60.4166666666667,39.5833333333333
"484","8","4",0,0,0,0,0,4,0,5,0,0,4,5,0,4,5,16,10,36,46,16,8,34.7826086956522,17.3913043478261,78.2608695652174,21.7391304347826
"485","8","5",0,0,0,0,0,0,0,2,0,0,0,2,0,3,3,27,3,37,40,27,0,67.5,0,92.5,7.5
"486","8","6",0,0,0,0,0,0,0,1,0,0,0,1,1,1,2,28,3,34,37,28,0,75.6756756756757,0,91.8918918918919,8.10810810810811
"487","80","1",11,5,5,3,4,6,5,3,5,3,6,5,4,5,3,0,44,32,76,11,12,14.4736842105263,15.7894736842105,42.1052631578947,57.8947368421053
"488","80","2",0,1,4,2,2,10,7,5,0,6,8,10,4,8,5,14,33,56,89,14,18,15.7303370786517,20.2247191011236,62.9213483146067,37.0786516853933
"489","80","3",2,3,3,2,3,9,1,3,3,2,8,3,2,2,3,3,27,28,55,5,17,9.09090909090909,30.9090909090909,50.9090909090909,49.0909090909091
"490","80","4",1,3,2,3,2,2,3,5,3,2,2,5,2,5,4,1,21,27,48,2,4,4.16666666666667,8.33333333333333,56.25,43.75
"491","80","5",5,2,3,1,1,3,2,0,2,2,2,1,3,0,1,1,19,13,32,6,5,18.75,15.625,40.625,59.375
"492","80","6",1,2,4,1,3,3,3,1,2,3,2,3,3,2,1,0,20,17,37,1,5,2.7027027027027,13.5135135135135,45.9459459459459,54.0540540540541
"493","81","1",3,8,11,4,11,9,7,2,9,7,9,5,4,5,2,3,58,44,102,6,18,5.88235294117647,17.6470588235294,43.1372549019608,56.8627450980392
"494","81","2",2,5,5,4,6,7,5,4,5,4,8,5,4,5,4,4,40,40,80,6,15,7.5,18.75,50,50
"495","81","3",0,1,0,1,0,3,6,5,1,0,3,10,1,10,5,7,17,39,56,7,6,12.5,10.7142857142857,69.6428571428571,30.3571428571429
"496","81","4",1,3,0,3,0,1,0,8,3,0,1,5,2,5,7,14,16,40,56,15,2,26.7857142857143,3.57142857142857,71.4285714285714,28.5714285714286
"497","81","5",0,0,0,1,1,2,1,3,0,1,3,4,0,5,3,3,9,21,30,3,5,10,16.6666666666667,70,30
"498","81","6",1,1,2,0,2,3,0,3,2,1,3,3,1,3,4,12,15,29,44,13,6,29.5454545454545,13.6363636363636,65.9090909090909,34.0909090909091
"499","82","1",0,0,1,4,1,7,5,2,0,5,6,4,4,3,2,1,21,27,48,1,13,2.08333333333333,27.0833333333333,56.25,43.75
"500","82","2",2,1,1,3,2,3,3,7,1,3,4,7,2,8,7,17,22,52,74,19,7,25.6756756756757,9.45945945945946,70.2702702702703,29.7297297297297
"501","82","3",0,1,0,2,1,6,1,6,1,1,7,5,0,6,5,20,17,48,65,20,13,30.7692307692308,20,73.8461538461538,26.1538461538462
"502","82","4",0,0,0,0,0,2,0,5,0,0,2,5,0,4,4,9,7,27,34,9,4,26.4705882352941,11.7647058823529,79.4117647058823,20.5882352941176
"503","82","5",0,0,1,0,1,5,0,2,0,1,5,2,0,1,1,3,9,16,25,3,10,12,40,64,36
"504","82","6",0,0,0,0,0,0,1,4,0,1,0,5,1,5,4,7,7,24,31,7,0,22.5806451612903,0,77.4193548387097,22.5806451612903
"505","83","1",4,4,4,5,4,6,8,3,5,5,6,6,6,5,3,2,41,38,79,6,12,7.59493670886076,15.1898734177215,48.1012658227848,51.8987341772152
"506","83","2",21,4,5,2,5,0,1,1,4,3,1,0,2,1,1,1,41,14,55,22,1,40,1.81818181818182,25.4545454545455,74.5454545454545
"507","83","3",3,4,3,2,4,2,1,1,3,1,3,0,0,2,1,0,21,12,33,3,5,9.09090909090909,15.1515151515152,36.3636363636364,63.6363636363636
"508","83","4",0,0,0,1,0,0,2,0,0,1,1,0,1,1,0,0,5,5,10,0,1,0,10,50,50
"509","83","5",3,1,1,0,0,0,1,0,1,0,0,0,1,0,0,0,8,3,11,3,0,27.2727272727273,0,27.2727272727273,72.7272727272727
"510","83","6",2,2,2,2,2,1,2,2,2,3,1,2,2,2,2,0,17,15,32,2,2,6.25,6.25,46.875,53.125
"511","84","1",1,5,5,4,6,9,3,3,5,4,10,2,4,2,3,2,38,33,71,3,19,4.22535211267606,26.7605633802817,46.4788732394366,53.5211267605634
"512","84","2",22,7,10,3,10,2,3,1,7,6,3,1,3,1,1,0,60,23,83,22,5,26.5060240963855,6.02409638554217,27.710843373494,72.289156626506
"513","84","3",49,5,5,0,4,1,0,0,4,0,0,0,0,0,0,0,65,6,71,49,1,69.0140845070423,1.40845070422535,8.45070422535211,91.5492957746479
"514","84","4",43,7,5,2,5,0,1,1,6,1,0,0,2,0,1,0,66,11,77,43,0,55.8441558441558,0,14.2857142857143,85.7142857142857
"515","84","5",21,6,7,1,8,4,1,0,6,2,5,0,1,0,0,0,50,15,65,21,9,32.3076923076923,13.8461538461538,23.0769230769231,76.9230769230769
"516","84","6",11,4,4,3,4,1,5,2,5,3,1,3,4,3,2,0,37,21,58,11,2,18.9655172413793,3.44827586206897,36.2068965517241,63.7931034482759
"517","85","1",0,1,2,0,0,11,4,10,1,0,9,14,1,12,9,34,28,83,111,34,20,30.6306306306306,18.018018018018,74.7747747747748,25.2252252252252
"518","85","2",0,0,2,3,3,5,3,7,0,5,6,7,2,7,6,27,23,63,86,27,11,31.3953488372093,12.7906976744186,73.2558139534884,26.7441860465116
"519","85","3",0,0,0,3,1,0,2,4,0,3,1,3,2,5,4,3,11,23,34,3,1,8.82352941176471,2.94117647058824,67.6470588235294,32.3529411764706
"520","85","4",0,0,0,1,0,1,0,4,0,1,1,3,0,3,3,9,6,23,29,9,2,31.0344827586207,6.89655172413793,79.3103448275862,20.6896551724138
"521","85","5",0,0,0,0,0,0,0,1,0,0,0,1,0,2,2,9,2,16,18,9,0,50,0,88.8888888888889,11.1111111111111
"522","85","6",1,1,2,2,0,3,1,5,1,3,1,4,4,3,5,4,16,27,43,5,4,11.6279069767442,9.30232558139535,62.7906976744186,37.2093023255814
"523","86","1",0,0,0,0,0,0,0,1,0,0,0,1,0,0,0,1,1,5,6,1,0,16.6666666666667,0,83.3333333333333,16.6666666666667
"524","86","2",0,0,0,0,0,0,0,0,0,0,0,0,0,0,0,0,0,0,0,0,0,NA,NA,NA,NA
"525","86","3",0,0,0,0,0,0,0,0,0,0,0,0,0,0,0,0,0,0,0,0,0,NA,NA,NA,NA
"526","86","4",0,0,0,0,0,0,0,0,0,0,0,0,0,0,0,0,0,0,0,0,0,NA,NA,NA,NA
"527","86","5",0,0,0,0,0,0,0,0,0,0,0,0,0,0,0,0,0,0,0,0,0,NA,NA,NA,NA
"528","86","6",0,0,0,0,0,0,0,0,0,0,0,0,0,0,0,0,1,1,2,0,0,0,0,50,50
"529","87","1",4,4,4,7,3,8,7,10,5,6,7,10,8,9,10,12,50,67,117,16,15,13.6752136752137,12.8205128205128,57.2649572649573,42.7350427350427
"530","87","2",3,5,5,7,6,6,6,7,5,7,7,5,7,6,7,13,47,58,105,16,13,15.2380952380952,12.3809523809524,55.2380952380952,44.7619047619048
"531","87","3",0,3,3,1,3,10,1,1,3,1,10,1,1,2,1,0,23,21,44,0,20,0,45.4545454545455,47.7272727272727,52.2727272727273
"532","87","4",0,1,2,1,0,10,4,0,1,2,8,3,3,2,1,0,19,22,41,0,18,0,43.9024390243902,53.6585365853659,46.3414634146341
"533","87","5",0,0,0,1,0,5,1,3,0,1,5,3,1,3,3,3,10,22,32,3,10,9.375,31.25,68.75,31.25
"534","87","6",3,3,4,0,3,14,1,3,3,1,12,4,1,2,2,6,31,34,65,9,26,13.8461538461538,40,52.3076923076923,47.6923076923077
"535","88","1",6,5,5,2,5,5,3,1,5,1,5,2,1,2,1,0,33,19,52,6,10,11.5384615384615,19.2307692307692,36.5384615384615,63.4615384615385
"536","88","2",0,1,2,2,1,1,5,2,1,3,0,5,3,4,3,0,15,21,36,0,1,0,2.77777777777778,58.3333333333333,41.6666666666667
"537","88","3",0,1,1,3,1,2,0,4,1,3,2,1,3,1,4,1,14,17,31,1,4,3.2258064516129,12.9032258064516,54.8387096774194,45.1612903225806
"538","88","4",2,2,0,3,1,3,2,3,2,1,4,2,2,3,3,1,16,21,37,3,7,8.10810810810811,18.9189189189189,56.7567567567568,43.2432432432432
"539","88","5",9,0,0,0,1,1,0,0,1,0,2,0,0,1,0,0,14,4,18,9,3,50,16.6666666666667,22.2222222222222,77.7777777777778
"540","88","6",9,5,3,3,3,0,3,0,5,1,1,0,2,1,0,0,28,11,39,9,1,23.0769230769231,2.56410256410256,28.2051282051282,71.7948717948718
"541","89","1",0,0,2,2,0,2,5,4,0,4,0,7,4,5,4,9,15,36,51,9,2,17.6470588235294,3.92156862745098,70.5882352941177,29.4117647058824
"542","89","2",1,2,1,3,0,2,1,4,1,2,1,2,3,1,4,8,15,24,39,9,3,23.0769230769231,7.69230769230769,61.5384615384615,38.4615384615385
"543","89","3",0,0,0,0,0,1,0,2,0,0,2,2,0,3,2,3,5,13,18,3,3,16.6666666666667,16.6666666666667,72.2222222222222,27.7777777777778
"544","89","4",1,2,1,1,1,1,1,2,2,0,1,2,0,2,2,2,11,13,24,3,2,12.5,8.33333333333333,54.1666666666667,45.8333333333333
"545","89","5",0,0,0,0,0,0,1,0,0,0,0,0,0,1,0,0,2,3,5,0,0,0,0,60,40
"546","89","6",0,0,0,0,0,0,0,0,0,0,0,0,0,0,1,4,1,7,8,4,0,50,0,87.5,12.5
"547","9","1",2,3,3,3,5,4,6,2,3,3,5,5,2,6,2,1,30,28,58,3,9,5.17241379310345,15.5172413793103,48.2758620689655,51.7241379310345
"548","9","2",0,0,0,3,1,0,0,5,0,3,2,2,1,4,5,12,11,30,41,12,2,29.2682926829268,4.8780487804878,73.1707317073171,26.8292682926829
"549","9","3",0,0,0,2,1,2,2,3,0,2,3,3,1,4,3,4,10,23,33,4,5,12.1212121212121,15.1515151515152,69.6969696969697,30.3030303030303
"550","9","4",0,0,0,0,0,0,0,3,0,0,0,3,0,3,3,23,3,35,38,23,0,60.5263157894737,0,92.1052631578947,7.89473684210526
"551","9","5",0,0,0,2,0,0,0,4,0,2,0,2,2,2,4,25,6,40,46,25,0,54.3478260869565,0,86.9565217391304,13.0434782608696
"552","9","6",0,0,0,2,0,0,0,8,0,2,0,6,2,6,8,14,11,40,51,14,0,27.4509803921569,0,78.4313725490196,21.5686274509804
"553","90","1",10,3,3,0,2,1,1,0,3,0,0,0,1,0,0,0,21,6,27,10,1,37.037037037037,3.7037037037037,22.2222222222222,77.7777777777778
"554","90","2",8,8,8,5,9,10,4,2,8,5,11,1,3,3,2,2,55,37,92,10,21,10.8695652173913,22.8260869565217,40.2173913043478,59.7826086956522
"555","90","3",1,2,4,2,4,18,3,3,2,4,18,4,2,5,4,7,38,48,86,8,36,9.30232558139535,41.8604651162791,55.8139534883721,44.1860465116279
"556","90","4",1,2,4,4,5,16,3,4,2,6,18,2,3,4,4,6,41,46,87,7,34,8.04597701149425,39.0804597701149,52.8735632183908,47.1264367816092
"557","90","5",2,3,3,4,4,6,3,3,3,4,7,2,3,2,2,5,28,31,59,7,13,11.864406779661,22.0338983050847,52.5423728813559,47.4576271186441
"558","90","6",7,3,4,1,3,2,2,2,4,2,1,3,3,2,3,4,27,22,49,11,3,22.4489795918367,6.12244897959184,44.8979591836735,55.1020408163265
"559","91","1",10,7,9,4,9,10,4,5,7,5,10,5,3,5,5,4,59,46,105,14,20,13.3333333333333,19.047619047619,43.8095238095238,56.1904761904762
"560","91","2",18,13,11,7,11,7,6,7,14,5,7,6,7,6,7,2,83,54,137,20,14,14.5985401459854,10.2189781021898,39.4160583941606,60.5839416058394
"561","91","3",93,11,10,1,9,3,2,1,12,0,2,1,3,0,1,2,133,21,154,95,5,61.6883116883117,3.24675324675325,13.6363636363636,86.3636363636364
"562","91","4",103,8,11,0,11,0,0,0,8,3,0,0,0,0,0,0,136,11,147,103,0,70.0680272108844,0,7.48299319727891,92.5170068027211
"563","91","5",121,2,2,0,2,0,0,0,2,0,0,0,0,0,0,0,130,2,132,121,0,91.6666666666667,0,1.51515151515152,98.4848484848485
"564","91","6",149,0,0,0,0,0,0,0,0,0,0,0,0,0,0,0,152,0,152,149,0,98.0263157894737,0,0,100
"565","92","1",3,4,5,4,3,21,10,9,4,5,18,15,6,13,9,20,60,92,152,23,39,15.1315789473684,25.6578947368421,60.5263157894737,39.4736842105263
"566","92","2",0,0,0,4,2,19,2,14,0,4,21,12,2,15,14,38,42,108,150,38,40,25.3333333333333,26.6666666666667,72,28
"567","92","3",0,0,0,2,0,8,0,12,0,2,8,10,2,10,12,48,22,95,117,48,16,41.025641025641,13.6752136752137,81.1965811965812,18.8034188034188
"568","92","4",0,0,1,1,0,3,2,5,0,2,2,6,2,4,5,18,13,41,54,18,5,33.3333333333333,9.25925925925926,75.9259259259259,24.0740740740741
"569","92","5",0,0,0,1,0,11,2,9,0,2,11,9,2,9,9,51,25,94,119,51,22,42.8571428571429,18.4873949579832,78.9915966386555,21.0084033613445
"570","92","6",0,0,0,2,2,4,0,8,0,2,6,6,0,7,7,70,16,101,117,70,10,59.8290598290598,8.54700854700855,86.3247863247863,13.6752136752137
"571","93","1",0,1,0,4,1,3,4,4,1,3,4,4,3,5,4,4,19,29,48,4,7,8.33333333333333,14.5833333333333,60.4166666666667,39.5833333333333
"572","93","2",1,1,1,0,0,0,1,0,1,0,0,0,1,0,0,0,6,3,9,1,0,11.1111111111111,0,33.3333333333333,66.6666666666667
"573","93","3",0,0,0,0,0,0,0,0,0,0,0,1,0,0,0,0,1,3,4,0,0,0,0,75,25
"574","93","4",0,0,0,0,0,0,0,0,0,0,0,0,0,0,0,0,0,0,0,0,0,NA,NA,NA,NA
"575","93","5",0,0,0,0,0,0,0,0,0,0,0,0,0,0,0,0,1,1,2,0,0,0,0,50,50
"576","93","6",0,0,0,0,0,0,0,0,0,0,0,0,0,0,0,0,2,1,3,0,0,0,0,33.3333333333333,66.6666666666667
"577","94","1",0,0,1,3,1,2,2,1,0,4,2,0,3,1,2,3,11,17,28,3,4,10.7142857142857,14.2857142857143,60.7142857142857,39.2857142857143
"578","94","2",0,0,0,0,0,0,0,0,0,0,0,0,0,0,0,0,2,0,2,0,0,0,0,0,100
"579","94","3",0,0,0,0,0,0,0,0,0,0,0,0,0,0,0,0,0,0,0,0,0,NA,NA,NA,NA
"580","94","4",0,0,0,0,0,0,0,0,0,0,0,0,0,0,0,0,0,0,0,0,0,NA,NA,NA,NA
"581","94","5",0,0,0,0,0,0,0,0,0,0,0,0,0,0,0,0,0,0,0,0,0,NA,NA,NA,NA
"582","94","6",0,0,0,0,0,0,0,0,0,0,0,0,0,0,0,0,0,0,0,0,0,NA,NA,NA,NA
"583","95","1",10,6,10,8,8,9,7,9,6,12,7,8,10,6,9,16,70,74,144,26,16,18.0555555555556,11.1111111111111,51.3888888888889,48.6111111111111
"584","95","2",9,7,5,6,6,7,2,6,8,4,8,2,6,3,7,2,51,40,91,11,15,12.0879120879121,16.4835164835165,43.956043956044,56.043956043956
"585","95","3",5,3,1,4,2,7,4,3,2,2,8,3,2,4,3,6,30,32,62,11,15,17.741935483871,24.1935483870968,51.6129032258064,48.3870967741936
"586","95","4",2,2,1,5,2,2,5,3,3,3,3,3,4,4,3,7,25,30,55,9,5,16.3636363636364,9.09090909090909,54.5454545454545,45.4545454545455
"587","95","5",2,3,3,1,2,3,1,0,3,1,2,1,1,0,0,0,16,10,26,2,5,7.69230769230769,19.2307692307692,38.4615384615385,61.5384615384615
"588","95","6",2,1,1,1,3,3,2,0,2,1,5,0,0,2,0,0,16,10,26,2,8,7.69230769230769,30.7692307692308,38.4615384615385,61.5384615384615
"589","96","1",0,1,0,1,0,1,2,1,1,0,1,2,1,2,1,0,7,10,17,0,2,0,11.7647058823529,58.8235294117647,41.1764705882353
"590","96","2",0,1,3,0,2,0,0,0,1,2,0,0,0,0,0,0,8,4,12,0,0,0,0,33.3333333333333,66.6666666666667
"591","96","3",0,0,0,0,0,0,0,0,0,0,0,0,0,0,0,0,0,1,1,0,0,0,0,100,0
"592","96","4",0,0,0,0,0,0,0,0,0,0,0,0,0,0,0,0,0,0,0,0,0,NA,NA,NA,NA
"593","96","5",0,0,0,0,0,0,0,0,0,0,0,0,0,0,0,0,0,0,0,0,0,NA,NA,NA,NA
"594","96","6",0,0,0,0,0,0,0,0,0,0,0,0,0,0,0,0,0,0,0,0,0,NA,NA,NA,NA
"595","97","1",0,1,1,1,1,1,0,2,1,1,0,1,1,0,1,5,7,13,20,5,1,25,5,65,35
"596","97","2",0,0,0,0,0,0,0,0,0,0,0,0,0,0,0,0,0,0,0,0,0,NA,NA,NA,NA
"597","97","3",1,1,1,0,2,2,0,0,1,1,2,0,0,0,0,0,9,5,14,1,4,7.14285714285714,28.5714285714286,35.7142857142857,64.2857142857143
"598","97","4",0,1,2,0,2,6,1,1,1,1,5,2,1,1,1,0,15,13,28,0,11,0,39.2857142857143,46.4285714285714,53.5714285714286
"599","97","5",8,1,3,0,1,6,1,1,2,1,4,2,2,0,1,3,24,15,39,11,10,28.2051282051282,25.6410256410256,38.4615384615385,61.5384615384615
"600","97","6",2,1,0,0,0,2,1,0,1,0,1,1,1,0,0,0,8,5,13,2,3,15.3846153846154,23.0769230769231,38.4615384615385,61.5384615384615
"601","98","1",4,6,5,7,3,7,5,12,6,6,6,10,9,8,12,13,51,71,122,17,13,13.9344262295082,10.655737704918,58.1967213114754,41.8032786885246
"602","98","2",2,4,7,4,7,13,7,4,4,8,13,7,5,7,5,5,50,55,105,7,26,6.66666666666667,24.7619047619048,52.3809523809524,47.6190476190476
"603","98","3",1,1,2,2,1,1,4,1,1,3,0,4,2,3,1,0,14,16,30,1,1,3.33333333333333,3.33333333333333,53.3333333333333,46.6666666666667
"604","98","4",9,6,5,4,5,8,4,1,6,4,8,1,5,1,1,0,44,27,71,9,16,12.6760563380282,22.5352112676056,38.0281690140845,61.9718309859155
"605","98","5",19,5,7,0,6,3,1,0,4,2,2,1,1,0,0,0,43,11,54,19,5,35.1851851851852,9.25925925925926,20.3703703703704,79.6296296296296
"606","98","6",0,1,2,0,2,4,3,3,1,1,4,7,0,6,3,2,16,26,42,2,8,4.76190476190476,19.047619047619,61.9047619047619,38.0952380952381
"607","99","1",18,6,5,2,4,9,7,3,6,2,8,8,3,7,3,4,56,42,98,22,17,22.4489795918367,17.3469387755102,42.8571428571429,57.1428571428571
"608","99","2",2,5,5,8,5,7,4,13,4,8,7,10,7,10,13,20,50,81,131,22,14,16.793893129771,10.6870229007634,61.8320610687023,38.1679389312977
"609","99","3",0,0,0,0,0,5,2,8,0,0,5,10,0,10,7,73,15,108,123,73,10,59.349593495935,8.13008130081301,87.8048780487805,12.1951219512195
"610","99","4",0,0,0,1,0,0,0,6,0,1,0,5,1,5,5,86,7,106,113,86,0,76.1061946902655,0,93.8053097345133,6.19469026548673
"611","99","5",1,3,1,4,1,9,10,11,3,2,9,17,4,17,10,27,40,92,132,28,18,21.2121212121212,13.6363636363636,69.6969696969697,30.3030303030303
"612","99","6",0,0,2,2,1,8,4,11,0,4,7,13,3,12,12,42,29,95,124,42,15,33.8709677419355,12.0967741935484,76.6129032258064,23.3870967741935
